..####...
..#*.#...
###..####
#..@!...#
#.+@@.+.#
###.+####
..#..#...
..####...
