#######....
#*....#####
#.+.@!@.+.#
#.+@!.!@+.#
#.+.@!@.+.#
######....#
.....######
