.####.....
.#..######
.#.....+*#
##.##@##+#
#..#.@.#.#
#...!@@#..
##.#.@.+.#
##.##@#..+
#..##@#.##
#.++.+#..#
#..#.....#
#######..#
......####
