.#########
.#...#...#
.#.+++++.#
##.+.+.+.#
#.+..*...#
#.+.####.#
#..#@@@@@.
##..@@@@@.
.#########
