......###.....
.######*#####.
.#@@@@@@@@@@#.
##@!!!!!!!!@##
#@@!@@@@@@!@@#
#@@!@!!!!@!@@#
######@@######
.#..........#.
.#.+.++++.+.#.
.#+++....+++#.
.#...++++...#.
.#+.+....+.+#.
##...++++...##
#.+++....+++.#
#.....#......#
##############
