#########.
#.+.@@..#.
#*++@@.+##
#.+.@@.+.#
######...#
.....#####
