.#######.
.#.*@@@#.
.#...####
###+....#
#...#+#.#
#.+.#...#
#...#####
#####....
