#########
#@@@##..#
#@!@..+*#
#..+#..##
###.##.##
#...+....
#..+##+#.
#....+..@
#########
