.##########
##.+..!@!.#
#..+..!@!.#
#..+..!@!*#
#..+..!@!.#
#..+..!@!.#
###########
