######...#####
#....###.#..@#
#..+.+.#.#@@@#
#.#..+.###..@#
#..+++...+.*@#
###..+..+#..@#
..#..+#+.#@@@#
..##.....#..@#
...###########
