......######
......#.....
......#.#.#.
......#..+.+
#######...+.
#@@#..##.+.+
#@@...##.+.+
#@@#..##.###
#@@#.#.+.+.#
#@@.....+..#
#..###.*.###
####.#####..
