########
#...#..#
#.+....#
##.##+.#
.#..+.+#
.#.#..+.
.#.+.#+.
.#.....#
.###.+.#
...###.#
....#..+
....#...
....####
