#########
#*..+.@.#
#.+.+@+.#
#@!@!@!@#
#.+@+.+.#
#.@.+...#
#########
