...##########.
####@@@@@@..#.
#...@@@@@#..#.
#..#@@@@@@.##.
##.####+##+#..
#*+..+.+...###
#.++....##...#
#.#..++##..#.#
#...+..#.++..#
#..+..+...#+.#
####...#.+.+.#
...#...#.....#
...###########
