..........####
...########...
...#...+...+.+
...#.#.#.#.+##
...#.....+...+
...########+.#
..##......#...
..#*+..+..#.+.
######.#+.#+#+
#@@@@#.+..#...
#@!@@###.##.##
#@@!@.+...#..#
#@@@@+.+.....#
#@@@##########
#####.........
