.......#######
....####@@@@@#
#####...@@@@@#
#...#..#@.@@@#
#.+*##.###.###
#..+...+..++.#
#...#+...+...#
#.+.#.##+..+.#
###....+.##..#
..#.+.+.+...##
..###....####.
....######....
