......######
......#.....
......#+.+++
......#...#.
......#...+*
....###+.+.#
....#...+#+#
#####.#..#..
#@@@..#.+#.#
#@@@@@...#.#
#@@@@@#.+#.#
########...#
.......#####
