.....#####.....
...###...#.....
...#...#.#.....
.###..+..######
.#..#+#..#....#
.#+.+.##...+..#
##..#....+++###
#....###+...#..
#.+#++@@@####..
#....#@@@@#....
#.#.*.#@@@#....
#.....+@@@#....
##..#.....#....
.##########....
