....#####.....
#####...######
#.....#..##..#
#.#.++...+....
#..#...##.#.#.
#.+.#.##...+..
#....+.+...#.#
##.+.#..#+##.#
.###..#.#.#.+#
...#.+..*.@@@#
...#.+##+#@@@#
...##...@@@@##
....###.@@@##.
......######..
