......#######
.....##.....#
....##..+##..
....#..#...+.
....#.#..#.#.
....#.+.+..+.
#######.#+#..
#..+.+......#
#*@@+.!!@####
##@@@@@@##...
.########....
