..##########...
..#....#...#...
..#.+#...+.#...
..#.+.+#+#.#...
.###@#@@@..####
##..@@@@#+.#...
#.+#@##!#..+++.
#...@@@@@*#.+..
#..#@#@@@..+.+.
#.++..+#+#..+..
#...#..#..#...#
######....#####
.....######....
