############
#@@@.#.....#
#@@..#.##..#
#@@.....#..#
#@@..#.+##.#
#@@@.#+.+..#
######..++.#
.##..+.++..#
.#*.+++..#.#
.##.+.##...#
..#........#
..##########
