.######.#####.
##*#..###...##
#....+..#.+..#
#..+..#....+.#
###.######...#
###.##..##+###
#.+..####.@@#.
#.+.+.+..@@@#.
#....####@@@#.
#.++.#..#@@@#.
#..###..#####.
####..........
