...#####.
####..*##
#.+.+...#
#.#@!@#.#
#.#@!@#.#
#...+.+.#
##...####
.#####...
