.....#####....
.....#*..####.
..#####+....#.
..#@@@#..#.+##
..#@!@#+.#+..#
###@@@.+.#.#.#
#..@@##+#....#
#..####..#.+.#
##...+...#++.#
.#..##.##...##
.#####......#.
.....#..#####.
.....####.....
