...######.....
...#....##....
...#.+.+.##...
####.#+#..####
#.+....+..#..#
#....+.#.+@@@@
###.#.####@@@@
.##.#+.+..@@##
.#..#...+#..#.
.#*+..+..####.
.#..######....
.####.........
