#########.....
#.......##....
#.#+#+#*.#####
#.+....+.#...#
##.####.##.#.#
#..#..#......#
#.+#..+..#####
#@@+..##.#...#
#@@#..#...++.#
#@@####..+...#
#!@@@#.+.+.+.#
#@@@@#.......#
##############
