...#######.....
...#.....######
...#..+#......#
####+..+..#++.#
#....++.+...+.#
#.+#..##.###.##
#.*##+.+..+..#.
#.....+..+.+.#.
##########++.#.
..#@@@@@@@@@##.
..#@@@@@@@@@#..
..###########..
