....######
..###....#
..#...#+..
..#...+...
..#.++.#+.
..##...+..
######.#+#
#@@*.#+..#
#@#@@..+##
#@@@@+#.#.
#@@@@...#.
#########.
