###############
#......#......#
#.+.#+.#.+##+.#
#.#..+.#......#
#...##+#+##++.#
#.#.#.@@@.#...#
#.+..@.#.@+.#.#
#.+#*+@@@#.#..#
#....@.#.@..+.#
#.##@+###+@.#.#
#.#.+@@@@@.##.#
#.............#
###############
