.#########......
.#..#....#######
.#....+...#....#
##@####.+.+*+#.#
#@@@@###..##.+.#
#@@@@####+.#...#
#@@@@........+.#
###.####+#.+.+.#
#........##..###
#.++.+.#######..
#..#####........
####............
