########......
#......#......
#.++...###....
#..+.+++.#####
##.##.@@@....#
.#.#*#@@@###+.
.#.#.+@@@.....
##.#.+@@@+.#.#
#..#####.###.#
#......+...+.#
###########..#
..........####
