.####.#####....
.#..###...##...
.#.+..#.#..##..
.#.+#.#.##..##.
.#...+..#.+..##
.#.+..+.#+.+..#
###.#.###.#.+.#
#.....#@@@@#..#
#.#.++.@@@@##.#
#.#...#@@@@...#
#..##+#@@@@#*##
#.+.+...#.####.
##....#.+.#....
.######.+.#....
......##..#....
.......####....
