..#####........
###...##.......
#......#.......
#.++.#+########
##.#+.+.+.#...#
#@@@@#...+....#
#@@@@*#..###+##
#@@@@+#...+.+.#
#@@@@+.+#.....#
#####...#.+#+##
....#####...+.#
........###...#
..........#####
