..##########
###*..@....#
#...##+##..#
#..+@.@.@+##
##.+##+##.#.
.#....@...#.
.##########.
