.#####.######
.#...###....#
##.+.+.#+.#+#
#..+.*.+..+.#
#.#..##.#@@@@
#..##.+.#@##@
##..+....@@@@
.#.++.#+#@@@@
.#...#...#+.#
.#####.+....#
.....####..##
........####.
