..########....
..#...#..###..
###.#.+..+.###
#....#++.#...#
#.##+#..*..+.#
#....++###+.##
#...+#.##..##.
#.#+.#.@@@##..
#.+.#@@@@@#...
##..@@@@@##...
.#.+#.####....
.##...#.......
..#####.......
