.#####........
##...##.......
#.....#####...
#.#....+..#...
#..#.+.##.#...
##.++#@@@.#...
.###..@@@.#...
...####@@#####
######@@@##..#
#..###.+*.#+.#
#.+.#...#....#
#..+..#+..+.##
##....+..####.
.#####..##....
.....####.....
