#########
#.......#
#..+.+.+#
##.#+##.#
.#.@@.@@#
.##@@.@@.
..#.##+#.
..#+.+.+.
..#......
..#######
