......####.....
......#..######
......#....#..#
......#.++....#
#######+#..#..#
#..#@!@@.###+##
#..#@#!@+.....#
#..#@#@!#.#...#
#.++@@@@#.#####
#.*+.#....#....
#.+++#....#....
#....######....
######.........
