########
#@@@@@@#
#..+.#.#
#.+.#.+.
##+.+.+.
.#..*...
.#######
