....######.....
.####....######
.#..#.+....#..#
.#.+..#++..++.#
.#..+#..#@@#@.#
##+..#.#@@@!@##
#.+.#.+.@@##@.#
#.#+.+.#@@@@@.#
#....#..#..####
#.+#..#...*##..
#....+#.#..#...
####..+.####...
...#..###......
...####........
