.....######.
.#####....#.
.#..#..+.+#.
.#..+.#.+.##
##..#..#..+.
#.+#..*.#...
#....+.+#.++
#..+.#+@!@.#
##..#.+@@@##
.####.#@@@@#
....#..@@@@#
....########
