##############
#.......###..#
#.++.+....++.#
#.....+.###..#
##+#####..#.##
##.#.@@@@@#..#
##.#.@@@#@#..#
#...#@@@@@#+.#
#...#@!@@@+*##
#.+.#..###.###
#.+.###.+.+..#
#.+++.....++.#
#...###......#
##############
