#########
#*..!...#
#.+@+@+.#
#.@+@+@.#
#..@+@+.#
#...!...#
#########
