...######
#####...#
#.+..@..#
#.+.@@###
#*+.++###
###.@+@.#
.##+@@@+.
.#.+@##..
.#...####
.#####...
