....#####....
..###...###..
.##@+.....##.
.#@.+++++..#.
##..#...#..##
#..#!#*#!#..#
#...#...#...#
##.@+++++@.##
.##@@@@@@@##.
..#########..
