........####
..#######..#
..#....##...
..#.#...+@#.
..#...+.#@.*
..##..##@@@.
...##+.+@@@.
..##..##@!@#
###.+....###
#.++.#+#+##.
#.#.....+.#.
#....##...#.
###..######.
..####......
