###############
#.............#
#.+@+@+@+@+@#.#
#.@+@+@+@+@+..#
#.+@+@+@+@+@#*#
#.@+@+@+@+@+..#
#.+@+@+@+@+@#.#
#.............#
###############
