#######
#..!.*#
#.+!+.#
#..@..#
#.+!+.#
#+@!@.#
#@.@+@#
#.+@..#
#######
