.#########.
.#.......##
.#+.####..#
##.#.@!.#.#
#...+!@.#.#
#.#+*@!.#.#
#....+....#
####+##+.##
...#.@@@.#.
...#######.
