#######
#.+@.*#
#..@..#
#++!+.#
#@@!@@#
#.+!+.#
#.+@+.#
#..@..#
#######
