.....#####
######@@@#
#...+*.+##
#..+.#.+.#
#@.+.#+..#
#.####.#@#
#@.....+@#
##########
