....######.....
#####....######
#...#...*..#..#
#..+@!!!!!!@+.#
####....#..#..#
...##...#....##
....##########.
