....####....
....#.*###..
..###.+..##.
.##..+@+..#.
.#..+@!@+.##
##.+@!@!@+..
#.+@!@!@!@+.
#..+@!@!@+.#
###.+@!@+..#
..#..+@+..##
..##..+.###.
...###..#...
.....####...
