#########
#...*...#
#+++++++#
#@@@#@@@#
#@@@@@@@#
#+++.+++#
#.......#
#########
