#########
##.....##
#.#@+.+.#
#.@!@+..#
#.+@#@+.#
#..+@#@.#
#.+.+@#.#
##..*..##
#########
