###############
#..@@@@@@@@@..#
#.+++++++++@+.#
#.+@@@@@@@+@+.#
#.+@+++++@+@+.#
#.+@+@@@+@+@+.#
#.+@+@+!+@+@+*#
#.+@+@+@@@+@+.#
#.+@+@+++++@+.#
#.+@+@@@@@@@+.#
#.+@+++++++++.#
#..@@@@@@@@@..#
###############
