#######
#..@.*#
#.+@+.#
#.!@+.#
#@+!+@#
#.+@!.#
#.+@+.#
#..@..#
#######
