##########.
#.....#..#.
#..+.+#..##
#..##@#...#
##+##@##+.#
#.+@@@@@..#
#*+##@##+##
##.##@#...#
#...+.+...#
#...#...###
#########..
