.#######........
.#.....#...#####
.#..##.#####...#
.#+.+.+..#...#.#
.#.+.+.#.......#
##..++.###+###.#
#.+....#@@@@#..#
#*#++.##@@@@#..#
#..+...#@@@@+..#
##..##.#@@@@#.##
.#++#..##.###..#
.#......+......#
.############..#
............####
