........######
....#####.....
.####.+.+.+.+.
.#..#..+.###..
.#....*....#+.
.#.###.###....
.#.#@@@@@#.++.
.#.#@@@@@#..+#
##+#@@@@@+...#
#....##.#..###
#.+.+...++.#..
##..#####..#..
.####...####..
