...####.....
####..######
#.....##...#
#.+#.+....+#
##.###.+#..#
.#.+.+..##.#
.#...+.##..#
.#+.#@@@!.+.
.#.*#.@@@@@@
.###########
