###########....
#...##@@@@#####
#..+..@@@##...#
###++.@@###.#.#
..#.##@@@##+..#
..#.#...###..##
.##.#.+..+.+.#.
.#..#.#.#....#.
.#....#.+.#+.#.
.#.++.#.+#..##.
.###.##..#.##..
...#*......#...
...#########...
