..#########...
..#....#..#...
###.#+..+.####
#..+..##@@#..#
#.#..+.#@@+.+.
#.++..+#@@..#.
##..#..@@@#+..
.#+.*.#@@@#.+.
.#....#@@@+..#
.#.##+.###...#
.#...+.....###
.#..########..
.####.........
