.....####
.#####...
.#.@@.+#.
.#.#@!...
##.!@#+.#
#.+..+..#
#...##.*#
#########
