#########
#*..!...#
#.++@+..#
#@@@@!!!#
#.++@+..#
#...!...#
#########
