#####.#######
#...###..#..#
#.+.....+.*.#
##.#+##@##..#
.#..@@@!@.+.#
.#.+#.#@#.#.#
.##....+....#
..#..########
..####.......
