.####
.#...
.#...
.#...
.#..#
##..#
#...#
#.*.#
#..##
#...#
#...#
#####
