....#####......
#####...#......
#...+.*.#......
#..+.#@#####...
##+.##@##..####
.#..@@@@@.+#..#
.#.+##@##..#+.#
.#...#@##.....#
.###.+.#####.##
...#.#+.....+.#
...#....###...#
...######.#####
