####...........
#..#...........
#..##########..
#....##.....#..
#@@#....++#.#..
#@@..##...+.###
#@@#..##+#.+..#
#@@...#.*+.+..#
#@@#..#.+.+...#
#.@...#.+.+.###
#..#..#...###..
#..#....###....
#########......
