############
#....@@@.+.#
#.+++!!!.+*#
#....@@@.+.#
############
