#####...........
#@@@#.#####.....
#@@@###...#.....
#@@@@...++#####.
#@@@@..#..#...##
#@@#+####.#+#..#
##.+..#.....++.#
#..+#.*.+.++#..#
#.+.+.+.#...+.##
#...#..+.##...#.
######...######.
.....#####......
