..#####....
..#...#....
###+@+#####
#...@.+...#
#.##+##.*.#
#...@.#####
###.@.#....
..#...#....
..#####....
