.....#######.
.....#..#..#.
.....#..++.#.
######.+#..#.
#@@@###.#..##
#@..#..+.#..#
#@....+.+.+.#
#@..#..+.#..#
#@@@###.#..##
######.+...#.
.....#*.#..#.
.....#######.
