....#####....
....#...#....
.####.#.#####
##...+.+....#
#.+#.#@@@#+.#
#*+..@@@#..##
#.+#.@@#.+..#
##...@#.....#
.###.+.+.#..#
...###...####
.....#####...
