..#########..
..#.......#..
.##+.+.+.+##.
##..+.+.+..##
#.+..#.#..+.#
#...#@@@#...#
##.#@@@@@#.##
.#.#@@@@@#.#.
.#..#@#@#..#.
.#+.+.+++.+#.
.#..#...#..#.
.####.*#####.
....####.....
