.#####...
.#...####
##.#+*..#
#.+..++.#
#.#+#@!@#
#....@@@#
#########
