........####
........#...
#########.#.
#.+.+.+.+...
#.#@#@#@#*+#
#@@@@@@@...#
#.#.#.#.#+##
#.+.+.+.+...
#########.#.
........#...
........####
