..#####..
###.*.###
#..+.+..#
#.!@!@!.#
#.@+.+@.#
#.!@!@!.#
#..+.+..#
######..#
.....####
