.##############.
.#*..!.!.!.#..##
.#+#..!.!..#...#
.#.#.!.!.!.....#
.#.#..!.!..##.##
.#.#.!.!.!.##.#.
.#.#..!.!..##.#.
.#.#.!.!.!.##.#.
.#.#..!.!..##.#.
.#.#.!.@.!.##.##
##.##########..#
#..............#
#...#########..#
#####.......####
