#######....
#.*#..#####
#.++..+...#
#..#@##+#.#
##+#@@@...#
##.@@@##+##
#..##@##..#
#..+..+...#
#..#...#..#
###########
