.#############.
.#....#..##..#.
.#+++.#.++..+##
.#.+..#..@@@@.#
.#..+..#+@##@.#
.#..#.+#.@@@@##
##+.+..#+@##@.#
#.+..+.*+@@@@.#
#...###..######
#####.####.....
