.....########
.....#.......
.....#..+#+#.
.######..#.+.
.#...#.+..+..
##.+.....###.
#...#+####...
#....+.###.##
#####@@.*#.##
...#@@@+.++.#
...#@@@#....#
...#@@@######
...#####.....
