....####......
.####..####...
.#..#...+.####
.#@@@.+#+.#..#
##@#@..#...+.#
#@@@@@.###+..#
#@@@@#+#..+.##
###+##.++...#.
.#...#....+.#.
.#.+..*+..###.
.####+#.###...
....#...#.....
....#####.....
