####..........
#..####..#####
#.+...####...#
#.+....##....#
#.###+.+..+..#
#.#.+..+.##...
#..+.#++#...#.
##...#..#+....
.##..##..+.#.#
####@###..+#.#
#..#@#@@.#...#
#..#@@@@.*.###
#.+.@@@@#.##..
#...##@@..#...
###########...
