......#####
#######...#
#...##@...#
#..+#@@..##
##..@@@#++.
.#.+@#@+...
.#.+###+##.
.#...#.....
.##++#.##+#
.#@@@.+*.+.
.#@@@#+#...
.#@@@..####
.#######...
