.####..######
.#..####....#
##!...!.!!..#
#.+.!....!#.#
#.@...###...#
######...#*##
#.!.@.!..!!.#
#...#...#...#
##!...!.#+#.#
.#..#####...#
.####...#####
