####..
#*.###
#.++@#
#..+@#
#.+.@#
#.#.@#
######
