...#######.....
...#.....#.....
...#.+.+.##....
...#####@@#####
######@@!@..+.#
#..+*+@@@@#++.#
#...+.#+###...#
#####.......###
....###..####..
......#..#.....
......####.....
