.........#####..
.........#...#..
##########.!.###
#..........@...#
#.++++!!!!+@@@*#
#..........@...#
##########.!.###
.........#...#..
.........#####..
