#######..
#..@+.###
#.@+@+..#
#!+@+@*.#
#.@+@+.##
#..@+..#.
########.
