...#####...
...#.*.#...
...#.+.#...
...#+@+#...
..##@+@##..
###@+@+@###
#..+@+@+..#
#....@....#
###########
