.....####....
######..#####
#*+....+..+.#
#+###.+.#.#.#
#..#..#.+...#
#.+#....#.###
#..+.#+#...#.
#@@@@@@@@@.#.
########...#.
.......#####.
