.####..........
##..###########
#.+.+.+.+.+.+.*
#.#.........+..
#.#..####!###+#
#.#..#@@@@@#..#
#.#+.#@!!!@!..#
#.#..!@@@@@#..#
#.#.+#######++#
#.............#
###########.#.#
..........#...#
..........#####
