###########
#.+@.+.@..#
#..#..+@..#
#@@!@@#!#@#
#++#+++@.+#
#..@+*+@..#
#+.@+++#++#
#@#!#@@!@@#
#..@+..#..#
#..@+.+@..#
###########
