...#####...
...#...#...
...#.++#...
####.@.####
#.+.!@!...#
#.+@@@@@+.#
#...!@!.+.#
####.@.####
...#+++#...
...#.*.#...
...#####...
