#######
#..@..#
#..@+.#
#.+!@.#
#!.@+!#
#.!!+.#
#..@+.#
#.+@.*#
#######
