#######
#*.!..#
#.+@.+#
#+.!..#
#@!@!@#
#..@+.#
#.+@+.#
#..!..#
#######
