#########
#*......#
#.+@+@+.#
#.@+@+@.#
#.+@!@+.#
#.@+@+@.#
#.+@+@+.#
#.......#
#########
