..#####.....
..#...######
###+#@.....#
#.+.@@@#.+.#
#*.+@#!+...#
####....####
...######...
