###########
#....#....#
#.+*+++++.#
#.........#
#####.#####
...#@..#...
...#@..#...
...#@@@#...
...#@..#...
...#####...
