..#####..
..#.*.#..
..#.+.#..
###.@.###
#...!...#
#.!!!!!.#
#...!...#
###+!+###
..#.@.#..
..#.!.#..
..#.@.#..
..#####..
