##############
#@...........#
#@+.+.+.+.+..#
#@#########..#
#@#@!.+.@@+!##
#@#.+.+.!@+*#.
#@#@..+.@@++#.
#@#########@#.
#@..........#.
#@#+#+#+#+#+#.
#@..........#.
#############.
