...#####.
####@..##
#.+@+@..#
#*+#.#+.#
#.+@.@..#
####+#+.#
..#@.@..#
..#######
