.######..
##..@*##.
#.!.#..##
#...#...#
#.+##.#.#
#..+.+!@#
#..@#...#
#########
