########
#..#@@.#
#.+@*+!.
#..+.+..
#.!+.@+.
##.@@#..
.#######
