########
#..*...#
#.##+#.#
#.+..+.#
##+..###
.#@+.@#.
.#@@.@#.
.######.
