.######
##.@.*#
#.+.+.#
#@.!.@#
#.+.+.#
#..@.##
######.
