#######
#@.@.@#
#.+++.#
#@+*+@#
#.+++.#
#@.@.@#
#######
