...#####
...#.*.#
...#+++#
####...#
#...@#+#
#.+@+@.@
#..#@#@#
########
