...########
####*...@.#
#..+.+.+@.#
#..@###.@##
#.+@+.+..#.
#..@..####.
#######....
