..######..
###...@#..
#..+@#####
#.++@#*..#
#...##++.#
#..@+@...#
###+.###@#
..#@.#.###
..####....
