...######
####@..*#
#..+++..#
#@##@##@#
#...+...#
#..+@#.##
###....#.
..######.
