##########
#@@......#
#@@+..#..#
#..#+##.##
#.+.....#.
#####.#.#.
..#.+.*.#.
..#.....#.
..#######.
