.####...
.#*.###.
.#.+..#.
###.#.##
#@#.#..#
#@+..#.#
#@...+.#
########
