.#######.
.#.....##
##+###...
#.*.+..+.
#.@@#.+.#
##@@#...#
.########
