.......####
.......#*.#
...#####..#
####......#
#...@###.##
#.#.#....##
#.#.+.+#@.#
#.#..!..#.#
#.@#+.+.#.#
##....#.#.#
.#.###@...#
.#.....####
.#######...
