...######
..##..#.*
..#...#..
..#+.+.+.
..#.+##..
###.+.#.#
#@@@@@..#
#########
