...######.
.###....#.
##@.+##.##
#@@+.+..*#
#@@.+.+.##
#####...#.
....#####.
