.#########.
.#..##...#.
.#...+...#.
.#+.###.+#.
.#.#@@@#.#.
##.#@@@#.##
#.+..+..+.#
#.....#.*.#
###########
