..######
..#....#
###+++.#
#*.+@@.#
#.+@@@##
####..#.
...####.
