.####..#####
##..#..#...#
#.+.####+..#
#..+@@@@.+.#
##....#.*.##
.##########.
