..#####.
###..*#.
#..+@.##
#..@+@.#
###.!+.#
..#...##
..#####.
