..####..
..#@@#..
.##.@##.
.#..+@#.
##.+..##
#..#++.#
#..*...#
########
