..######..
..#....###
..#.+....#
###.+.##.#
#@@@.+...#
#@@@+#+.##
####.#.+.#
...#..*..#
...#######
