..########
..#...#@.#
.##..+@@@#
.#..+.#!@#
##.##+#.##
#...+..+.#
#...#....#
#######*.#
......####
