########
#..#...#
#.+@@+.#
#*+@!.##
#.+@@+.#
#..#...#
########
