.#######..
.#@@@@.#..
###@@@+###
#..+#+.+.#
#.++..#+.#
#....#...#
####.*.###
...#####..
