.......######
.......#.....
.......#.#.#.
.......#..+.+
.......#...+.
.......##.+.+
.###....#.+.+
##@######.###
#@@@..#.+.+.#
##@@.....+..#
#@@@..#..*###
##@####..##..
.###..####...
