#######
#@@+@@#
#@@#@@#
#.+++.#
#..+..#
#.+++.#
#..#*.#
#######
