.#######.
##..!..##
#.@*@.@.#
#.+.!...#
#!++!++!#
#...!.+.#
#.@.@.@.#
##..!..##
.#######.
