.......#########
########*##..@@#
#......+.....@@#
#.+.#+.#+##..@@#
##.##....####@@#
.#.+.+##.#..####
.#.##.#..#......
##.#....##......
#..+...##.......
#..##+.#........
#..##..#........
########........
