...#####
...#...#
####+..#
#@@.+..#
#@@+..##
#@@#.+#.
#.@#+.##
####.+.#
..#.+..#
..#..*.#
..######
