........########
........#......#
........#..+.+.#
.########.+.+..#
##@@@..####.##.#
#@@@@.......##.#
##@@@..##.++##.#
.########.+....*
......###.####.#
......#.+.+....#
......#..+.#####
......##...#....
.......#####....
