########.
#......#.
#.#++..#.
#.@@@#.#.
##@@@+.##
.#.##.+.#
.#+..+..#
.#..#..*#
.########
