..#####...
###...####
#...+.+..#
#.+...+.*#
###++#####
..#..@@#..
..#@@@@#..
..######..
