...######
.###.....
##...#.#.
#..#@+++.
#.#@!#.##
#..@@#.#.
###@@+.##
..#@#.+.#
.##.#.#*#
.#.+..+.#
.#.....##
.#######.
