.....####
######..#
#....+..#
#.##.+..#
#.+.+..+.
#.#..++.#
#.*++....
####..#..
...#.+###
...#+.+.#
..##.#..#
..#..+++.
..#.....#
..#..####
..####...
