.......####...
########..####
#...##@@@@@..#
#..+..##@@@#.#
##..+..###.#.#
.#.#.+..#....#
.#..#.+..#...#
.#...#.+..#..#
.#....#.+.#.##
.####..#.+..#.
....##..#.+.#.
.....##*#...#.
......#######.
