..#####......
..#...#######
..#.+.+......
#####..+.#++.
#...#.##....#
#@@@...##..+#
#@@@#++..+..#
#@@@#..*#..##
############.
