.#######.######.
.#.....###....#.
.#..##.#..++#.##
.#+.+.+.+.+....#
.#.+.+.#...#...#
##..++.######@##
#.+....#...#@@@#
#*#++.##...#@@@#
#..+...#...#@@@#
##..#+.#...#@@@#
.#++#..#####@@@#
.#.....+....@@@#
.###########...#
...........#####
