.#########
##*......#
#...#+#+.#
#.++..@+@#
#..###@@@#
####.#####
