..........#######
..........#..@@@#
......#####..@@@#
......#......@@@#
......#..##..@@@#
......##.##..@@@#
.....###.########
.....#.+++.##....
.#####..+.+.#####
##...#+.+...#...#
#*.+..+....+..+.#
######.++.+.#####
.....#.+....#....
.....####.###....
........#..#.....
........#..#.....
........#..#.....
........####.....
