####......####
#@@########@@#
#!@!@@@@@!@!@#
#.+.+.+.+.+.+#
#+.+.+*+.+.+.#
#.+.+.+.+.+.+#
#+.+.+.+.+.+.#
#@!@!@@@@@!@!#
#@@########@@#
####......####
