#####......####
#*..########..#
##.+.......+..#
.#.#.#..####..#
.#..+...####+##
.#+.##.#.+.+.#.
##.+..+#.....#.
#...#......#.#.
#...#####+####.
#####...#...#..
....#@@@..+.#..
....#@@@@#..#..
....#@@@@####..
....######.....
