.............####
......########..#
.....##.+.+...+.#
.....#...*#+..+.#
.....#..+.#..#..#
########.+#.....#
#...+.....+.+.###
#...#####+##+##..
##.++.........#..
.#..##.+.+.+..#..
.######.#.#.###..
.....#.+.+..#....
.....#..+..##....
....####.+###....
....#@@@@@@@#....
....#@@@@@@@#....
....#@@@@@@@#....
....#########....
