.....#####....
.....#*..#####
...####.+..+..
.###...++.+.+.
.#...#..+#.###
.#+####..+...+
.#.+..+..+...+
.#..+..###+###
##..##.#@@@@@#
#..+.+.#@@@@@.
#.+...+.@@@@@#
########@@@@@#
.......#######
