.####....
.#..####.
.#+.*..#.
##..##+##
#.!#@#..#
#.@@!++.#
#.@#@#..#
##...#.##
.###.+..#
...#.#..#
...#...##
...#####.
