....#########....
....#.......#....
....#++.++#.####.
#####..#..+.#..#.
#@@#..##.+..+..#.
#@@#.++.....#..#.
#@@#..##+####.##.
#@@##.##....#.#..
#@@@...##.###.###
#...##...+......#
######*#...##.#.#
.....########...#
............#####
