........
..######
###...#.
#..++.#.
#.#...#.
#.#...#.
#.#.####
#.#+.###
#.#..#..
#.....+.
#.#..###
#.####..
#......#
########
