#########
#*.@....#
#.++@++.#
#@!@@@!@#
#.++@++.#
#.+@....#
#########
