.....######
.#####@...#
.#..#@@##.#
.#..+@@...#
.#..#.@#.##
###.##+#..#
#.+....++.#
#.#+#..#..#
#*..#######
#####......
