..#######.######....
.##.....###....#....
.#..###...#.++.###..
.#.#.*.#..#..+...#..
.#.#+++#.####+##.###
##...........+.#@@@#
#..#+#+##..#...#@@@#
#.#..+..#.#.##.#@@@#
#.#.....#.#....#@@@#
#..#+++##.#+...#@@@#
##.........++###@@@#
.#.#+#+##.#+....@@@#
.#.#....#.#.+...@@@#
.#.#....#.#..#######
.#.#+++##.#..#......
.#........####......
.###....###.........
...######...........
