########........
#@@@...########.
#@@@@.....+...##
#@@@@@##.+.#+..#
#@@@@@#..#..+..#
#######+.##..+.#
.#........###.+.
.#..+.#.+..#..+.
.#..###.##..#.##
.#..#..+..+.#...
.####.#+#..##+..
..#*+....+...+..
..#####...######
......#####.....
