####..........
#..###........
#.+..###......
#.+.+..###....
#.+.+.+..###..
#.+.+.+....#..
#.+.+..#...##.
#.+..##.+++.#.
#*.####.....##
##.#.#@+++++@#
.#.###@@@@@@@#
.#...@!!!!!!!@
.####@@@@@@@@@
....##########
