.......#####
.......#....
.......#.+++
.......#.+.+
...#####..+.
...#...####.
...#........
...###.####.
....#@@@@##.
....#@@@@#..
....#@@@@#..
#####@###...
#..##.#.#.##
#.+##+###..#
#......+...#
#.+#...##..#
##*#########
.###........
