.########.
.#@@@@@@#.
.#@@##@@#.
.#@@@@@@#.
.#@@!!@@#.
.###@@###.
.#..++..#.
.#......#.
.#.++++.#.
###....###
#..++++..#
#........#
#.++++++.#
##......##
#.++++++.#
#...*....#
#..####..#
####..####
