##################
#.........##.#@@@#
#.+.++#....+.#@@@#
#.+...#+##++.#@@@#
#.++#+.......*@@@#
#.+.+.+#+.####..@#
#...##.......+@@@#
##################
