.########.
.#..#*..##
##.+###..#
#...!.!..#
#..!.!.!.#
#.@.!.!..#
####...###
...#####..
