........#########
......###...#...#
......#*+..+.++.#
###.######......#
#@###...##..##+.#
#@@@@@!@..##.+..#
#.!##..#+.#..+..#
#...#..+..@@@@@@#
##.+##..#########
.#.+.####........
.#.+.+.#.........
.#.....#.........
.#######.........
