##############
#...##.@@@@@@#
#..###.@@#@#.#
#.+#..@@##@.@#
##.#.+#.#....#
#.+..+....#.##
#.+#.#.+###+.#
#*.#.#.+..#..#
#.+#.##+#.#+.#
#.+...#......#
###...#.##+.##
..#####.....#.
......#######.
