.......####....
########..#####
#.........#...#
#....#.##..#..#
##..#.....#....
.#...##...#.+++
.#.........#...
.#..#..#.#.#+#.
.####..+.+.#...
..#.+.#####.###
..#..@@@@@@@@@@
..###..#######.
....####.....##
