...#####.
.###...##
##.*.+.+.
#..##.##.
#.+@#@+..
#.#@#!#..
#.+@@@..#
###+#.###
..#...#..
..#####..
