.######....####..
.#....######..#..
.#*#.+........##.
#####+.+.####..##
#....+...#......#
#..++.#.##+###++.
#.....+!@!@@#....
#######@@@@!#.+..
......#!@@!@#.#+#
......#@@@@!.+...
......#@@@@@#.+++
......#####.#.#..
..........#.#.+.+
..........#..+...
..........#..###.
..........####.##
