......#####........
.....##...##.......
....##..!..##......
...##..!.!..##.....
..##..!.!.!..##....
.##..!.!.!.!..####.
##..!.!.!.!.!..#.##
#..!.!.!.!.!.!....#
#.!.!.!.@.!.!.!*+.#
#..!.!.!.!.!.!....#
##..!.!.!.!.!..#.##
.##..!.!.!.!..####.
..##..!.!.!..##....
...##..!.!..##.....
....##..!..##......
.....##...##.......
......#####........
