.####....
.#..#####
##+.##..#
#..+*+..#
#...##+.#
###@##.##
.#@@@+.+.
.##@@....
..#######
