....#######.....
....#...#*#.....
.####.#.#.#####.
.#....#.......#.
.#.+#+#######.#.
##+...#@@#@@#+##
#....++@@@@@#..#
#.+.+.#@@@@@++.#
##...##@@@#@#..#
.#.+..##@@@##+.#
.#.##.#######..#
.#......+.+.+.##
.######...+.#.#.
......##.#.+..#.
......#.++.+..#.
......#...+...#.
......######..#.
...........####.
