####.####
#..###..#
#....+..#
#..#.#..#
##.#.#+##
#..#@#..#
#..!@!.*#
#..#@#.##
####...#.
...#.#+#.
...#...#.
...#####.
