.......#####
..######...#
###....@.+.#
#.+..#+@#+##
#..#..*@#..#
##.####@...#
.#.+..#!####
.#.##.#@..#.
.#.....@#.#.
.###+.....#.
...#..#####.
...####.....
