##########.
#........##
#.+#+#+#+*#
#@.@+@@@+@#
#@.@+@@@+@#
#.+#+#+#+##
#........#.
##########.
