######..#####
#....####...#
#.+...+...#.#
##..#.###.+.#
.#++..###+#.#
##...#..@@@.#
#..#.+..+@@@#
#..#####@@###
#.*#...####..
####.........
