.......####.####....
.....###..#.#..#....
..####..+.###.+#....
..#.+...+......#....
###..##.+..+..+#....
#.......#.+.##.#....
#.#++++#.++.+..#....
#....+.++.####.#####
####....+.*##.@@@@@#
.#..++##.####.@@@@##
.#.+..#@@@@##.@@###.
.#.#..+@@@@######...
.####..@@@@#........
....########........
