#########.
#...##..#.
#.#.+.+.#.
#..!@#..#.
##.#@*@##.
##+###!###
#........#
#...##.#.#
######...#
.....#####
