#######.....
#.@@@@#.....
#.@@@@#.....
#.@@@@#.....
##+#########
#.+.+......#
#...#......#
###.#.++.+.#
..#.#...#+.#
..#.#.++...#
..#.#.#.++.#
..#.#..+.###
..#.###..#..
..#....#*#..
..####...#..
.....#####..
