..##################
..#.......##@@@#...#
..#.#+#+#.###@@@.+.#
..#..*+..+...@@#.+.#
#####+#+#.#..@@..###
#...+.+.#.######.##.
#.#.#.#.#.........#.
#.......#######...#.
#########.....#####.
