.####....
.#..#....
.#+.###..
.#...*#..
##.#@.###
#..#!@+.#
#.++@@#.#
##.##@..#
.#.+..###
.#..###..
.#..#....
.####....
