.....#######
.....#....@@
.....#.#..@@
.....#.##..@
######.+.+.#
#@@@+.+.+*##
#@@#.+.+.+##
#@@@#.+.+...
#@@@.+.+..#+
#..####.+.+.
#..#..#..+..
####..##...#
.......#####
