.#####.....
.#.*.######
.#.#@@!...#
.#.@@@#...#
##+##.+.+.#
#...#+#####
#...+...#..
#####.#.#..
....#...#..
....#####..
