.....######...
...###....##..
...#...##..#..
.###+##..#.#..
##.....@@#.#..
#..+#+#!@#.#..
#.++*.#@!#.###
#..++.#@@#...#
##....#@@+...#
.###+##@.#.###
...#..###..#..
...##.....##..
....#######...
