#############
#..+.+.+@!@@#
#.+.+.+.!@@@#
#..+.+.+@!@@#
#.+.+.+.!@@@#
#..+.+.+@!@@#
#.+.+.+.!@@@#
#..+.+.+@!@@#
#.+.+.+.!@@@#
#..+.+.+@!@@#
#*+.+.+.!@@@#
#############
