....#####..........
....#...#..........
....#+..#..........
..###..+##.........
..#..+.+.#.........
###.#.##.#...######
#...#.##.#####..@@#
#.+..+..........@@#
#####.###.#*##..@@#
....#.....#########
....#######........
