....#####...........
....#...#...........
....#+..#...........
..###..+##..........
..#..+.+.#..........
###.#.##.#...######.
#...#.##.#####..@@#.
#.+..+..........@@#.
#####.###.#*##..@@#.
....#.....#########.
....#######.........
