.###..#############.
##*####.......#...#.
#.++...++..+.+.@@@#.
#..+++#....+..#@@@#.
#.+...#.++.++.#@@@#.
###...#..+....#@@@#.
#.....#.+.+.+.#@@@#.
#....######.###@@@#.
##.#..#..+.+..#@@@#.
#..##.#.++.+.+##@@#.
#.@@#.#..+......#@#.
#.@@#.#.+++.+++.#@#.
#####.#.......#.#@#.
....#.#########.#@#.
....#...........#@#.
....###############.
