.###..#############
##*####.......#...#
#.++...++..+.+.@@@#
#..+++#....+..#@@@#
#.+...#.++.++.#@@@#
###...#..+....#@@@#
#.....#.+.+.+.#@@@#
#....######.###@@@#
##.#..#..+.+..#@@@#
#..##.#.++.+.+##@@#
#.@@#.#..+......#@#
#.@@#.#.+++.+++.#@#
#####.#.......#.#@#
....#.#########.#@#
....#...........#@#
....###############
