..........####......
.....####.#..#......
...###.*###+.#......
..##......+..#......
.##..+.++##.##......
.#..#+##.....#......
.#.#.+.++.#.###.....
.#...+.#..#.+.#####.
####....#..++.#...#.
####.##.+.........#.
#@....###..########.
#@@.@@#.####........
#@@@#@#.............
#@@@@@#.............
#######.............
