################
#..............#
#.#.######.....#
#.#..+.+.+.+#..#
#.#...+*+...##.#
#.#..+.+.+###@@@
#.#...+.+..##@@@
#.###+++.+.##@@@
#.....#.##.##@@@
#####...##.##@@@
....#####.....##
........#.....#.
........#######.
