################..
#..............#..
#.#.######.....#..
#.#..+.+.+.+#..#..
#.#...+*+...##.##.
#.#..+.+.+###@@@#.
#.#...+.+..##@@@#.
#.###+++.+.##@@@#.
#.....#.##.##@@@#.
#####...##.##@@@#.
....#####.....###.
........#.....#...
........#######...
