...#########........
..##...##..#####....
###.....#..#....###.
#..+.#+.#..#..@@@.#.
#.#.+#*+##.#.#@#@.#.
#..#.#+..#....@.@.#.
#.+....+.#.#.#@#@.#.
#...##..##+.+.@.@.#.
#.+.#...#..#+#@#@.#.
##.+..+...+..+@@@.#.
.#+.######....##..#.
.#..#....##########.
.####...............
