...#########.......
..##...##..#####...
###.....#..#....###
#..+.#+.#..#..@@@.#
#.#.+#*+##.#.#@#@.#
#..#.#+..#....@.@.#
#.+....+.#.#.#@#@.#
#...##..##+.+.@.@.#
#.+.#...#..#+#@#@.#
##.+..+...+..+@@@.#
.#+.######....##..#
.#..#....##########
.####..............
