.......#######.....
.#######.....#.....
.#.....#.+*+.#.....
.#++.#...#########.
.#.###@@@@@@##...#.
.#...+@@@@@@##.#.#.
.#.###@@@@@@.....#.
##...####.###.#+##.
#..#+...#..+..#.#..
#..+.+++..#.+##.#..
#...+.+.###++.#.#..
#####.....+...#.#..
....###.###...#.#..
......#.....#...#..
......########..#..
.............####..
