.......#######...
.#######.....#...
.#.....#.+*+.#...
.#++.#...########
.#.###@@@@@@##...
.#...+@@@@@@##.#.
.#.###@@@@@@.....
##...####.###.#+#
#..#+...#..+..#.#
#..+.+++..#.+##.#
#...+.+.###++.#.#
#####.....+...#.#
....###.###...#.#
......#.....#...#
......########..#
.............####
