...########.......
...#...#..#.......
...#..+...#.......
.###.#+...####....
.#..+..##+...#....
.#..#.*.+.#.+#....
.#..#......+.####.
.##.####+##.....#.
.#.+#@@@@@#.#...#.
.#..+@@!!@.+#.###.
##..#@@@@@#...#...
#...###.#######...
#.++..#..#........
#..#.....#........
######...#........
.....#####........
