...#######
...#...#..
...#..+...
.###.#+...
.#..+..##+
.#..#.*.+.
.#..#.....
.##.####+#
.#.+#@@@@@
.#..+@@!!@
##..#@@@@@
#...###.##
#.++..#..#
#..#.....#
######...#
.....#####
