#####..........
#...##.........
#....#..####...
#.+..####..#...
#..++.+...+#...
###*.#+....##..
.#..##..+.+.##.
.#.+..##.##.@#.
.#..#+##+..#@#.
.###...+@@##@#.
..#....#@!@@@#.
..#.++.#@@@@@#.
..#..#########.
..#..#.........
..####.........
