#####........
#...##.......
#....#..####.
#.+..####..#.
#..++.+...+#.
###*.#+....##
.#..##..+.+.#
.#.+..##.##.@
.#..#+##+..#@
.###...+@@##@
..#....#@!@@@
..#.++.#@@@@@
..#..########
..#..#.......
..####.......
