...##########..
...#@@..#...#..
...#@@......#..
...#@@..#..####
..#######..#..#
..#............
..#..#..##..#..
####.##..####.#
#..+..#####.#..
#.#.+..+..#.+..
#.*+..+...#...#
####.##.#######
...#....#......
...######......
