...##########....
...#@@..#...#....
...#@@......#....
...#@@..#..####..
..#######..#..##.
..#............#.
..#..#..##..#..#.
####.##..####.##.
#..+..#####.#..#.
#.#.+..+..#.+..#.
#.*+..+...#...##.
####.##.#######..
...#....#........
...######........
