.....###########....
.....#..@..#...#....
.....#.#@....*.#....
.#####.##@@#.####...
##..#.@@###.....###.
#.+.#@@@...+.#..+.#.
#....@@.##..##.##.#.
####+##+#.+.#...#.#.
..##.#....#+.++.#.#.
..#..+.#.#..#.+##.#.
..#...............#.
..#..###########..#.
..####.........####.
