.....###########...
.....#..@..#...#...
.....#.#@....*.#...
.#####.##@@#.####..
##..#.@@###.....###
#.+.#@@@...+.#..+.#
#....@@.##..##.##.#
####+##+#.+.#...#.#
..##.#....#+.++.#.#
..#..+.#.#..#.+##.#
..#...............#
..#..###########..#
..####.........####
