..######............
..#...*####.........
#####.+...#.........
#...##....####......
#.+.#..##....#......
#.+.#..#####.#......
##.+..+....#.#......
##.+.+.###.#.#......
##.#..+..#.#.#......
##.#.#+#...#.#......
##.###...#.#.######.
#..+..####.#.#@@@@#.
#....+....+...@@#@#.
####+..+#.+...@@@@#.
#.......#..##.@@@@#.
###################.
