..######...........
..#...*####........
#####.+...#........
#...##....####.....
#.+.#..##....#.....
#.+.#..#####.#.....
##.+..+....#.#.....
##.+.+.###.#.#.....
##.#..+..#.#.#.....
##.#.#+#...#.#.....
##.###...#.#.######
#..+..####.#.#@@@@#
#....+....+...@@#@#
####+..+#.+...@@@@#
#.......#..##.@@@@#
###################
