############...
#@@..#.....###.
#@@..#.+..+..#.
#@@..#+####..#.
#@@....*.##..#.
#@@..#.#..+.##.
######.##+.+.#.
..#.+..+.+.+.#.
..#....#.....#.
..############.
