############..
#@@..#.....###
#@@..#.+..+..#
#@@..#+####..#
#@@....*.##..#
#@@..#.#..+.##
######.##+.+.#
..#.+..+.+.+.#
..#....#.....#
..############
