....##########......
#####........####...
#.....#...+..#*.#...
#.#######+####..###.
#.#....##.#..#+.@@#.
#.#.+.....#..#..#@#.
#.#.+..#.....#+.@@#.
#.#..###.##.....#@#.
#.###..#..#..#+.@@#.
#.#....#..####..#@#.
#.#+...+..+..#+.@@#.
#....+.#.+.+.#..#@#.
####.+###....#+.@@#.
...#....++.###@@@@#.
...#......##.######.
...########.........
