....##########...
#####........####
#.....#...+..#*.#
#.#######+####..#
#.#....##.#..#+.@
#.#.+.....#..#..#
#.#.+..#.....#+.@
#.#..###.##.....#
#.###..#..#..#+.@
#.#....#..####..#
#.#+...+..+..#+.@
#....+.#.+.+.#..#
####.+###....#+.@
...#....++.###@@@
...#......##.####
...########......
