#########
#.......#
#.......#
##.####.#
##.#*##..
#.+++.+..
#..#.##.+
#..#.##..
####..+++
.#...##..
.#.#...#.
.#...#.#.
.#####.+.
.....##..
......###
