#########.......
#.......#.......
#.......####....
##.####.#..#....
##.#*##....#....
#.+++.+..++#....
#..#.##.+..#....
#..#.##..+.####.
####..+++.+#..#.
.#...##...@@@@#.
.#.#...#.#@@.@#.
.#...#.#.##@@@#.
.#####.+..#@@@#.
.....##...#####.
......#####.....
