######.....####.....
#....#######..#####.
#...+#..#..+..#...#.
#..+..+..+.#.+.+..#.
##+.+...#.*#.+....#.
#..+.###########.##.
#.#...#@@@@@@@#.+#..
#.##..#.@@@@@@#..#..
#.#...+@@@@@@@@+.#..
#.#.+.#@@@@.@@#..#..
#..+.+####+####.+#..
#.+...###.+...+..##.
#.+.....+.+..+....#.
##.######.+.#####.#.
#.........#.......#.
###################.
