######.....####....
#....#######..#####
#...+#..#..+..#...#
#..+..+..+.#.+.+..#
##+.+...#.*#.+....#
#..+.###########.##
#.#...#@@@@@@@#.+#.
#.##..#.@@@@@@#..#.
#.#...+@@@@@@@@+.#.
#.#.+.#@@@@.@@#..#.
#..+.+####+####.+#.
#.+...###.+...+..##
#.+.....+.+..+....#
##.######.+.#####.#
#.........#.......#
###################
