....#######.......
....#..#..####....
#####.+#+.#..##...
#@@.#..#..#...#...
#@@.#.+#+.#..+####
#@..#.....#+..#..#
#@@...+#..#.+....#
#@@*#..#+.#+..#..#
#@@.#.+#.....+#..#
#@@.#..#++#+..#..#
#@@.#.+#..#..+#+..
#@@.#..#..#...#...
##@.####..#####...
.####..####...####
