....#######.........
....#..#..####......
#####.+#+.#..##.....
#@@.#..#..#...#.....
#@@.#.+#+.#..+####..
#@..#.....#+..#..#..
#@@...+#..#.+....#..
#@@*#..#+.#+..#..#..
#@@.#.+#.....+#..#..
#@@.#..#++#+..#..##.
#@@.#.+#..#..+#+..#.
#@@.#..#..#...#...#.
##@.####..#####...#.
.####..####...#####.
