###############.....
#@@@@@@@@@@..@####..
#@@@@@@@@@@++@#..#..
###########+.#...##.
#......+..+.....+.#.
##.####...#..+.#..#.
#......#...##..#.##.
#..+#..#.##..###.##.
#.+.#+###....###.##.
###..+.#..#..###.##.
###....+.##.#..#.##.
.#.+..#..+..+.+...#.
.#..+..+#+++..#...#.
.#..#..+......#####.
.#.*##..#..#..#.....
.##############.....
