###############...
#@@@@@@@@@@..@####
#@@@@@@@@@@++@#..#
###########+.#...#
#......+..+.....+.
##.####...#..+.#..
#......#...##..#.#
#..+#..#.##..###.#
#.+.#+###....###.#
###..+.#..#..###.#
###....+.##.#..#.#
.#.+..#..+..+.+...
.#..+..+#+++..#...
.#..#..+......####
.#.*##..#..#..#...
.##############...
