####................
#..##############...
#..#...@@#@@@@@@#...
#..#.#.#####.@@@#...
##+#....@@@@@@@@#...
#...##+######..####.
#.+.#.....######*.#.
##+.#.+...######..#.
#..+.#+++##.......#.
#......#....#+#+###.
#.####.#+++++....#..
#.#....+.....#...#..
#.#...##........###.
#.######+######.+.#.
#........#....#...#.
##########....#####.
