####.............
#..##############
#..#...@@#@@@@@@#
#..#.#.#####.@@@#
##+#....@@@@@@@@#
#...##+######..##
#.+.#.....######*
##+.#.+...######.
#..+.#+++##......
#......#....#+#+#
#.####.#+++++....
#.#....+.....#...
#.#...##........#
#.######+######.+
#........#....#..
##########....###
