.#######.......
.#..#..#####...
##..#..#@@@###.
#..+#..#@@@..#.
#.+.#++.@@@..#.
#..+#..#@@@.@#.
#...#.+########
##+.......+.+.#
##..#..++.#...#
.######..##++*#
......#......##
......########.
