.#######........
.#..#..#####....
##..#..#@@@###..
#..+#..#@@@..#..
#.+.#++.@@@..#..
#..+#..#@@@.@#..
#...#.+########.
##+.......+.+.#.
##..#..++.#...#.
.######..##++*#.
......#......##.
......########..
