.#################.
.#@@@...#....#...##
##@@@@@..+##.#.#+.#
#@@@@@@#..+..#....#
#@@@@@@#..#..#.#..#
#########.+..+.+..#
..#.....#+##+.##+##
.##...+....#.+....#
.#..##.###.#..##+.#
.#.+.++.....+..+..#
.#.+....+##+.######
.#######..*.##.....
.......######......
