.#################..
.#@@@...#....#...##.
##@@@@@..+##.#.#+.#.
#@@@@@@#..+..#....#.
#@@@@@@#..#..#.#..#.
#########.+..+.+..#.
..#.....#+##+.##+##.
.##...+....#.+....#.
.#..##.###.#..##+.#.
.#.+.++.....+..+..#.
.#.+....+##+.######.
.#######..*.##......
.......######.......
