.........#####...
.....#####...#...
....##.+..+..####
#####.+..+.+.##@#
#.......++..##@@#
#..######.###@@.#
##.#..#....#@@@.#
#.+...#....#@@@.#
#*.#+.##.####@@@#
####..+.++..##@@#
...##..+.+..+@@@#
....#.++..+.#..@#
....#...+.+..####
....######...#...
.........#####...
