.........#####....
.....#####...#....
....##.+..+..####.
#####.+..+.+.##@#.
#.......++..##@@#.
#..######.###@@.#.
##.#..#....#@@@.#.
#.+...#....#@@@.#.
#*.#+.##.####@@@#.
####..+.++..##@@#.
...##..+.+..+@@@#.
....#.++..+.#..@#.
....#...+.+..####.
....######...#....
.........#####....
