#####..............
#...##.............
#.+..#########.....
##.#.#.......######
##.#...+#+#*..#...#
#..#......+.#...+.#
#..###.#########.##
#..##.@@!@@@@@.#.##
##.##.!@!@@!@!.#.##
#.+##########.##+.#
#..+...+..+....+..#
#..#...#...#...#..#
###################
