#####...............
#...##..............
#.+..#########......
##.#.#.......######.
##.#...+#+#*..#...#.
#..#......+.#...+.#.
#..###.#########.##.
#..##.@@!@@@@@.#.##.
##.##.!@!@@!@!.#.##.
#.+##########.##+.#.
#..+...+..+....+..#.
#..#...#...#...#..#.
###################.
