........########..
........#.....*#..
........#.+#+.##..
........#.+..+#...
........##+.+.#...
#########.+.#.###.
#@@@@..##.+..+..#.
##@@@....+..+...#.
#@@@@..##########.
########..........
