........########.
........#.....*#.
........#.+#+.##.
........#.+..+#..
........##+.+.#..
#########.+.#.###
#@@@@..##.+..+..#
##@@@....+..+...#
#@@@@..##########
########.........
