.......###########
.......#...#.....#
#####..#.....+.+.#
#...#####.+##.#.##
#.+.##...#.##.+..#
#.+..*++.#.##+++.#
##.###...#.##....#
##.#...###.#####+#
##.#.....+..#@@@@#
#..###.##.+.#@@@@#
#.+...+.#...#@@+@.
#..##.+.#..##@@@@.
#####...######@@@#
....#####....#####
