.......###########..
.......#...#.....#..
#####..#.....+.+.#..
#...#####.+##.#.##..
#.+.##...#.##.+..#..
#.+..*++.#.##+++.#..
##.###...#.##....#..
##.#...###.#####+#..
##.#.....+..#@@@@#..
#..###.##.+.#@@@@##.
#.+...+.#...#@@+@.#.
#..##.+.#..##@@@@.#.
#####...######@@@##.
....#####....#####..
