..####............
..#..#########....
.##..##..#...#....
.#..+#.+*+...####.
.#+..+..#.+.+#..##
##..+##.#+.+.....#
#..#..#.#...+++..#
#.+....+..+##.####
#.+.+.#+#..#..#...
##..###..###+.#...
.#..#@@@@.....#...
.####@@@@@@####...
...#@@@@####......
...#@@@##.........
...#@@@#..........
...#####..........
