..####.............
..#..#########.....
.##..##..#...#.....
.#..+#.+*+...####..
.#+..+..#.+.+#..##.
##..+##.#+.+.....#.
#..#..#.#...+++..#.
#.+....+..+##.####.
#.+.+.#+#..#..#....
##..###..###+.#....
.#..#@@@@.....#....
.####@@@@@@####....
...#@@@@####.......
...#@@@##..........
...#@@@#...........
...#####...........
