......####..
..#####..#..
.##.....+#..
##.+..##.###
#*+.+.#.+..#
####.##...+#
.#@@@@#+.+.#
.#@@@@#...+#
.#@@@@..++.#
.#@@@.#.+...
.######+.+..
......#...##
......#+.###
......#..#..
......####..
