......####....
..#####..#....
.##.....+#....
##.+..##.###..
#*+.+.#.+..#..
####.##...+#..
.#@@@@#+.+.#..
.#@@@@#...+#..
.#@@@@..++.##.
.#@@@.#.+...#.
.######+.+..#.
......#...###.
......#+.###..
......#..#....
......####....
