.###########.
.#.....##..#.
.#...+...+.#.
####.##.++.#.
#...+.#....#.
#.+++.#.####.
#...#.#.+.##.
#..#..#..+.#.
#.+#.+#....#.
#...@@#.####.
####@@.+.#*#.
#@@@@@#.+#.#.
##@@@@#..+.#.
.##@@##....#.
..##########.
