.###########
.#.....##..#
.#...+...+.#
####.##.++.#
#...+.#....#
#.+++.#.####
#...#.#.+.##
#..#..#..+.#
#.+#.+#....#
#...@@#.####
####@@.+.#*#
#@@@@@#.+#.#
##@@@@#..+.#
.##@@##....#
..##########
