.#########...
.#@@@@...##..
.#@#@#..+.##.
##@@@@#.#.*##
#.@@@@#..#..#
#.....#+.##+.
##.###..+....
.#+..+.+.+#..
.#.#..+.+.##.
.#..###..##..
.#....##.##.#
.#..+.#..+..#
.###+.+...###
...#..#####..
...####......
