.#########.....
.#@@@@...##....
.#@#@#..+.##...
##@@@@#.#.*##..
#.@@@@#..#..##.
#.....#+.##+.#.
##.###..+....#.
.#+..+.+.+#..#.
.#.#..+.+.##.#.
.#..###..##..#.
.#....##.##.##.
.#..+.#..+..#..
.###+.+...###..
...#..#####....
...####........
