############.######.
#...#....#.###@@@@#.
#...++#...*..@@@@@#.
#...#.###...#.@@@@#.
##.##.###..#..@@@@#.
.#.+.+.....#.#.####.
.#..+.+##..#......#.
####.#..####.#.##.#.
#..#.#+...##.#....#.
#.+..+..#.##.#...##.
#.#.+.+....#.#...#..
#..+.##.##.#.#####..
#.++.....++..#......
##.##.###.+..#......
.#....#.#....#......
.######.######......
