############.######
#...#....#.###@@@@#
#...++#...*..@@@@@#
#...#.###...#.@@@@#
##.##.###..#..@@@@#
.#.+.+.....#.#.####
.#..+.+##..#......#
####.#..####.#.##.#
#..#.#+...##.#....#
#.+..+..#.##.#...##
#.#.+.+....#.#...#.
#..+.##.##.#.#####.
#.++.....++..#.....
##.##.###.+..#.....
.#....#.#....#.....
.######.######.....
