............#####...
#####..######...#...
#...####..+.+.+.#...
#.+...##.##.##..##..
#...+.+.....+..+.#..
###.+..##.##.....##.
..#.#####.#####++.#.
.##+#####.*##.....#.
.#.+..###+###.+..##.
.#.+..#...###..###..
.#.++.+.#...++.#....
.#.....#...##..#....
.#######@@.@###.....
....#@@@@@@@@@#.....
....#@@@@@@@@@#.....
....###########.....
