............#####
#####..######...#
#...####..+.+.+.#
#.+...##.##.##..#
#...+.+.....+..+.
###.+..##.##.....
..#.#####.#####++
.##+#####.*##....
.#.+..###+###.+..
.#.+..#...###..##
.#.++.+.#...++.#.
.#.....#...##..#.
.#######@@.@###..
....#@@@@@@@@@#..
....#@@@@@@@@@#..
....###########..
