###########........
#@@@@@@...#########
#@@@@@@...#..##...#
#@@###.+....+.....#
#@@@.+.+.#...##...#
#@@@#+#####....#..#
###....#...#+..#+.#
..#..++.+.+..+##..#
..#..+...#+#+.##+.#
..###.##.#....##..#
...#..+.+.##.######
...#....+..+..#....
...##...#.#...#....
....#####*#####....
........###........
