###########.........
#@@@@@@...#########.
#@@@@@@...#..##...#.
#@@###.+....+.....#.
#@@@.+.+.#...##...#.
#@@@#+#####....#..#.
###....#...#+..#+.#.
..#..++.+.+..+##..#.
..#..+...#+#+.##+.#.
..###.##.#....##..#.
...#..+.+.##.######.
...#....+..+..#.....
...##...#.#...#.....
....#####*#####.....
........###.........
