......####..
#######.*#..
#.....+..#..
#...+##.+#..
##+#@@@#.#..
.#.+@@@..#..
.#.#@.@#.##.
.#...#.#+.#.
.#+..+....#.
.#..#######.
.####.......
