......####
#######.*#
#.....+..#
#...+##.+#
##+#@@@#.#
.#.+@@@..#
.#.#@.@#.#
.#...#.#+.
.#+..+....
.#..######
.####.....
