............
.###########
##...##.....
#..++##..+.*
#......++.+#
#..+.##.++.#
#..+.##.+..#
##.#####.###
##...+..+.##
#.+###..#.##
#...+...#...
#..+.#+.+.+#
#.+++#.+...#
#....#..++.#
######...###
.....#####..
