.............######.
.#############@@@@#.
##...##.....##@@@@#.
#..++##..+.*##@@@@#.
#......++.+#..@@@@#.
#..+.##.++.#.#.@@@#.
#..+.##.+..#..@@@@#.
##.#####.###.##@###.
##...+..+.##...@..#.
#.+###..#.#####.###.
#...+...#.......#...
#..+.#+.+.+###..#...
#.+++#.+...#.####...
#....#..++.#........
######...###........
.....#####..........
