...........########
...........#..@@@@#
############..@@@@#
#....#..+.+...@@@@#
#.+++#+..+.#..@@@@#
#..+.....+.#..@@@@#
#.++.#+.+.+########
#..+.#.....#.......
##.#########.......
#....#....##.......
#.....+...##.......
#..++#++..*#.......
#....#....##.......
###########........
