...........########.
...........#..@@@@#.
############..@@@@#.
#....#..+.+...@@@@#.
#.+++#+..+.#..@@@@#.
#..+.....+.#..@@@@#.
#.++.#+.+.+########.
#..+.#.....#........
##.#########........
#....#....##........
#.....+...##........
#..++#++..*#........
#....#....##........
###########.........
