....############
....#..........#
....#..#.#++.+..
....#+.#+#..##.*
...##.##.#.+.#.#
...#...+.#+..#.#
...#...#.+...#.#
...##.+.+...##.#
...#..#..##..+.#
...#....##.++#.#
######++...#...#
#@@@@#..########
#@#@@@.##.......
#@@@@...#.......
#@@@@...#.......
#########.......
