....############..
....#..........##.
....#..#.#++.+..#.
....#+.#+#..##.*#.
...##.##.#.+.#.##.
...#...+.#+..#.#..
...#...#.+...#.#..
...##.+.+...##.#..
...#..#..##..+.#..
...#....##.++#.#..
######++...#...#..
#@@@@#..########..
#@#@@@.##.........
#@@@@...#.........
#@@@@...#.........
#########.........
