...........#####...
..........##...##..
.........##.....#..
........##..++..#..
.......##.++..+.#..
.......#.+....+.#..
####...#...++.#####
#..########.##....#
#@............+++*#
#@#.#######.##...##
#@#.#######@.#+.+##
#@@@@@@@@@@@.#....#
##############..+.#
.............##..##
..............####.
