...........#####....
..........##...##...
.........##.....#...
........##..++..#...
.......##.++..+.#...
.......#.+....+.#...
####...#...++.#####.
#..########.##....#.
#@............+++*#.
#@#.#######.##...##.
#@#.#######@.#+.+##.
#@@@@@@@@@@@.#....#.
##############..+.#.
.............##..##.
..............####..
