.....########......
..####......######.
..#....##.+.+...*#.
..#.##.##+#+.+.+##.
###.@@@@@@#..++.##.
#...@@@@@@#..#...#.
#.#.@@@@@@#+..+..#.
#.#+@@@@@@.++#.+.#.
#...###.###+..+.##.
###..+..+..+..+.#..
..#..+..+..+..+.#..
..######...######..
.......#####.......
