.....########.....
..####......######
..#....##.+.+...*#
..#.##.##+#+.+.+##
###.@@@@@@#..++.##
#...@@@@@@#..#...#
#.#.@@@@@@#+..+..#
#.#+@@@@@@.++#.+.#
#...###.###+..+.##
###..+..+..+..+.#.
..#..+..+..+..+.#.
..######...######.
.......#####......
