........#######.....
....#####..#..####..
....#...#...+....#..
.####.#++.##.##..#..
##......#.#..##.###.
#..###.+#+..+..+..#.
#@@@....#.##..#...#.
#@@@#....*.#.###.##.
#@@@#..###..+..+..#.
########.##...#...#.
..........#########.
