........#######....
....#####..#..####.
....#...#...+....#.
.####.#++.##.##..#.
##......#.#..##.###
#..###.+#+..+..+..#
#@@@....#.##..#...#
#@@@#....*.#.###.##
#@@@#..###..+..+..#
########.##...#...#
..........#########
