.#####.............
.#...#.............
.#.#.#######.......
.#......+*######...
.#.+.##+.###...#...
.#.####.+....+.#...
.#.#####.#..#+.####
##..####.##+......#
#..+#..+..#.##.##.#
#.........#.#@@@#.#
######..###..@@@..#
.....####.#.#@@@#.#
..........#.###.#.#
..........#.......#
..........#########
