.#####..............
.#...#..............
.#.#.#######........
.#......+*######....
.#.+.##+.###...#....
.#.####.+....+.#....
.#.#####.#..#+.####.
##..####.##+......#.
#..+#..+..#.##.##.#.
#.........#.#@@@#.#.
######..###..@@@..#.
.....####.#.#@@@#.#.
..........#.###.#.#.
..........#.......#.
..........#########.
