#####.####.....
#@@@#.#..####..
#@@@###..+..#..
#@@@@##.+..+###
##@@@@##...+..#
###@@@.##.+.+.#
#.##....#..+..#
#..##.#.###.###
#.+.#.#+..+....
#..+.*.+....+..
#...#.+.++.+.##
#..######..###.
#.##....####...
###............
