#####.####.......
#@@@#.#..####....
#@@@###..+..#....
#@@@@##.+..+###..
##@@@@##...+..#..
###@@@.##.+.+.#..
#.##....#..+..#..
#..##.#.###.####.
#.+.#.#+..+....#.
#..+.*.+....+..#.
#...#.+.++.+.###.
#..######..###...
#.##....####.....
###..............
