##########.....
#........####..
#.######.#..##.
#.#.+.+.+..+.#.
#.......#+...#.
###+..++#..###.
..#..##.#.+##..
..##+#...+.*#..
...#..+.+.###..
...#.#...+..#..
...#.##...#.#..
..##..#####.#..
..#.........#..
..#@@@@@@@###..
..#@@@@@@@#....
..#########....
