##########....
#........####.
#.######.#..##
#.#.+.+.+..+.#
#.......#+...#
###+..++#..###
..#..##.#.+##.
..##+#...+.*#.
...#..+.+.###.
...#.#...+..#.
...#.##...#.#.
..##..#####.#.
..#.........#.
..#@@@@@@@###.
..#@@@@@@@#...
..#########...
