.........####.....
.#########..##....
##..+......+.#####
#...##.##...##@@@#
#.#++.+.++#+##@@@#
#.#...*...#...@@@#
#..+#.###++...@@@#
#.+..++..+.##@@@@#
###+.......#######
..#..#######......
..####............
