.........####......
.#########..##.....
##..+......+.#####.
#...##.##...##@@@#.
#.#++.+.++#+##@@@#.
#.#...*...#...@@@#.
#..+#.###++...@@@#.
#.+..++..+.##@@@@#.
###+.......#######.
..#..#######.......
..####.............
