..#########..
..#!@!#!@!#..
..#@!@!@!@#..
..#!@!@!@!#..
..#@!@!@!@#..
..#!@!@!@!#..
..###...###..
....#...#....
######.######
#...........#
#.+.+.+.+.+.#
##.+.+.+.+.##
.#+.+.+.+.+#.
.#...+*+...#.
.#..#####..#.
.####...####.
