..#########...
..#!@!#!@!#...
..#@!@!@!@#...
..#!@!@!@!#...
..#@!@!@!@#...
..#!@!@!@!#...
..###...###...
....#...#.....
######.######.
#...........#.
#.+.+.+.+.+.#.
##.+.+.+.+.##.
.#+.+.+.+.+#..
.#...+*+...#..
.#..#####..#..
.####...####..
