.......####.......
.......#..##......
.......#...##.....
.......#.++.##....
.....###+..+.##...
..####....+...#...
###..#.#####..#...
#....#.#@@@@+.#...
#.#...+.@@@@#.#...
#..+.#.#@!@@#.#...
###..####.###.#...
..####.*+..##+##..
.....###.+.....#..
.......#..##...#..
.......#########..
