.......####....
.......#..##...
.......#...##..
.......#.++.##.
.....###+..+.##
..####....+...#
###..#.#####..#
#....#.#@@@@+.#
#.#...+.@@@@#.#
#..+.#.#@!@@#.#
###..####.###.#
..####.*+..##+#
.....###.+.....
.......#..##...
.......########
