........#####...
........#...####
........#.#+##..
........#.....+.
#########.###...
#@@@@..##.+..+##
#@@@@....+.++.##
#@@@@..##+..+.*#
#########..+..##
........#.+.+..#
........###.##.#
..........#....#
..........######
