........#####.....
........#...#####.
........#.#+##..#.
........#.....+.#.
#########.###...#.
#@@@@..##.+..+###.
#@@@@....+.++.##..
#@@@@..##+..+.*#..
#########..+..##..
........#.+.+..#..
........###.##.#..
..........#....#..
..........######..
