......###########
.....##@@....#...
....##@@!.+....+.
...##@@!@#.#.#.+#
...#@@!@#.#.#.+..
####@@@#..#....#.
#..##.#..........
#.*+.+.###..#...#
#.+...+...#.#...#
###++...#.#.#.#.#
..#...+...#.#.###
..#.+#.#####.....
..#+...#...#....#
..#..###...##....
..#..#......#....
..####......#####
