......############..
.....##@@....#...#..
....##@@!.+....+.#..
...##@@!@#.#.#.+##..
...#@@!@#.#.#.+..#..
####@@@#..#....#.#..
#..##.#..........#..
#.*+.+.###..#...##..
#.+...+...#.#...#...
###++...#.#.#.#.#...
..#...+...#.#.#####.
..#.+#.#####......#.
..#+...#...#....#.#.
..#..###...##.....#.
..#..#......#....##.
..####......######..
