.#########....
.#.......#....
.#.+.++.+#....
###.#..+.#....
#@#...++.##...
#@###...+.#...
#@#@.+.##.####
#@@@..+##.+..#
#@@@+...+....#
#@@###+###.#*#
#@@#.#.....###
####.#######..
