.#########.....
.#.......#.....
.#.+.++.+#.....
###.#..+.#.....
#@#...++.##....
#@###...+.#....
#@#@.+.##.####.
#@@@..+##.+..#.
#@@@+...+....#.
#@@###+###.#*#.
#@@#.#.....###.
####.#######...
