...........########.
...........#@@@@@@#.
...####....#@@@@@@#.
...#..#########@@@#.
...#.+...+....#@@@#.
...#..#.#.#.#.#...#.
#####.#.#.#*#.#...#.
#...#.###.###.##.##.
#....+.#.+.+.+.#.#..
#.+++..+...#.....#..
#...#.###+###+##.#..
###.#..+...#.....#..
.##.+..#.+.+.+.###..
.#..#.###.###.##....
.#.+..........#.....
.#..###########.....
.####...............
