...........########
...........#@@@@@@#
...####....#@@@@@@#
...#..#########@@@#
...#.+...+....#@@@#
...#..#.#.#.#.#...#
#####.#.#.#*#.#...#
#...#.###.###.##.##
#....+.#.+.+.+.#.#.
#.+++..+...#.....#.
#...#.###+###+##.#.
###.#..+...#.....#.
.##.+..#.+.+.+.###.
.#..#.###.###.##...
.#.+..........#....
.#..###########....
.####..............
