##################..
#................##.
#.+#...+.##..+....#.
#....+###....#.++.#.
#@###.....+.+.##..##
#@@@#..#..#....#+..#
#@@##++####.+..#...#
#@@@#......+.##..###
#@@@+..###..#....#.#
##@@..+#..##...##*.#
.##@#..............#
..##################
