##################...
#................##..
#.+#...+.##..+....#..
#....+###....#.++.#..
#@###.....+.+.##..##.
#@@@#..#..#....#+..#.
#@@##++####.+..#...#.
#@@@#......+.##..###.
#@@@+..###..#....#.#.
##@@..+#..##...##*.#.
.##@#..............#.
..##################.
