####################.
#...#....#...#...#*#.
#.+......+...+...#.#.
##.###@@##.###.....#.
#...#@@@@#+#..+###.#.
#.+.#@@@@#..+..+.+.#.
#...#@@@@#.#.#.+.+.#.
#...##@@##...#+#...#.
##+##....##..#..#+##.
#...+..+.....#..#..#.
#...#....#...#.....#.
####################.
