####################
#...#....#...#...#*#
#.+......+...+...#.#
##.###@@##.###.....#
#...#@@@@#+#..+###.#
#.+.#@@@@#..+..+.+.#
#...#@@@@#.#.#.+.+.#
#...##@@##...#+#...#
##+##....##..#..#+##
#...+..+.....#..#..#
#...#....#...#.....#
####################
