####################
#....*##......#...##
#....##....+....+.##
#..###@@@@#.#.#..###
#...#@@@@#.#.#.+...#
###.#@@@#..#.......#
##..##@#.....+...+.#
##..+.+.###..#.#.###
##.+.......#.#.+...#
####.+..+#.#.#.#.+.#
####.........#.#..##
####################
