####################.
#....*##......#...##.
#....##....+....+.##.
#..###@@@@#.#.#..###.
#...#@@@@#.#.#.+...#.
###.#@@@#..#.......#.
##..##@#.....+...+.#.
##..+.+.###..#.#.###.
##.+.......#.#.+...#.
####.+..+#.#.#.#.+.#.
####.........#.#..##.
####################.
