####################
#..#..##....#...*###
##....+....#.+###..#
##+#.+.##+#.+.+....#
#...+#....+......###
#.##...+.###..#@@@@#
#.#.+#.#.#.#.#@@@@##
#....+.+.#..#@@@@###
##+.###..+.#@@@@####
#..#.+........######
#......#.#....######
####################
