####################.
#..#..##....#...*###.
##....+....#.+###..#.
##+#.+.##+#.+.+....#.
#...+#....+......###.
#.##...+.###..#@@@@#.
#.#.+#.#.#.#.#@@@@##.
#....+.+.#..#@@@@###.
##+.###..+.#@@@@####.
#..#.+........######.
#......#.#....######.
####################.
