####################
#*.....###...#..#..#
#.#.#..#..+..+.....#
#####.....#.+.+#+#.#
#@#@@#....##+.+....#
#@@@@@....+...#...##
#@@@@@....###+##+###
#@#@@#....+....#...#
#####.....#..#+..+.#
#####..#..+....+.+.#
#####..#..#..#..#..#
####################
