####################.
#*.....###...#..#..#.
#.#.#..#..+..+.....#.
#####.....#.+.+#+#.#.
#@#@@#....##+.+....#.
#@@@@@....+...#...##.
#@@@@@....###+##+###.
#@#@@#....+....#...#.
#####.....#..#+..+.#.
#####..#..+....+.+.#.
#####..#..#..#..#..#.
####################.
