####################.
##@@@...##.#....#..#.
#@@@@.........+.##.#.
#@@@@#.#.#+###+....#.
#@@@#....#.......#.#.
##@#..#+.#.....+##.#.
#..#..#.+.+.###..+.#.
#.....+..+.#..#.##.#.
##.#.##.#++#.+#..#.#.
#..#...+.+.#......##.
#....#.....#..#...*#.
####################.
