####################
##@@@...##.#....#..#
#@@@@.........+.##.#
#@@@@#.#.#+###+....#
#@@@#....#.......#.#
##@#..#+.#.....+##.#
#..#..#.+.+.###..+.#
#.....+..+.#..#.##.#
##.#.##.#++#.+#..#.#
#..#...+.+.#......##
#....#.....#..#...*#
####################
