####################
#...#..#*#.##..#####
#.#.#..+....+..#####
#.#....######.+..###
#...#..#@@@@#..++..#
##+##+##@@@@#......#
#......#@@@@##+##+##
#..++..#@@@@#......#
#.+..+..#..#..###..#
#####..+...+....+..#
#####.#....#..#...##
####################
