####################.
#...#..#*#.##..#####.
#.#.#..+....+..#####.
#.#....######.+..###.
#...#..#@@@@#..++..#.
##+##+##@@@@#......#.
#......#@@@@##+##+##.
#..++..#@@@@#......#.
#.+..+..#..#..###..#.
#####..+...+....+..#.
#####.#....#..#...##.
####################.
