######..###..
#@@..#.##*##.
#@@..###...#.
#@@.....++.#.
#@@..#.#.+.#.
#@@###.#.+.#.
####.+.#+..#.
...#..+#.+.#.
...#.+..+..#.
...#..##...#.
...#########.
