######..###.
#@@..#.##*##
#@@..###...#
#@@.....++.#
#@@..#.#.+.#
#@@###.#.+.#
####.+.#+..#
...#..+#.+.#
...#.+..+..#
...#..##...#
...#########
