####################
#.#.....#..........#
#.......+..##.###.##
#####..##...+..+...#
##@@##..#.#.+.#.#..#
#@@@@..+.....##+#.##
#@@@@..+#####...#+##
##@@#.#..#...#..+..#
###@#.#..+...+..#.*#
##..+..+.#...#..####
##.......###########
####################
