####################.
#.#.....#..........#.
#.......+..##.###.##.
#####..##...+..+...#.
##@@##..#.#.+.#.#..#.
#@@@@..+.....##+#.##.
#@@@@..+#####...#+##.
##@@#.#..#...#..+..#.
###@#.#..+...+..#.*#.
##..+..+.#...#..####.
##.......###########.
####################.
