####################.
#.....###@@###.....#.
#.++..###@@###..+*.#.
#..#.##@@@@@@#..+..#.
#.....#@@@@@@#..+..#.
####..###@@######+.#.
#...+++.#@@#....#..#.
#.+#...+..+..++.#+.#.
#..#..##.+..##..#..#.
#.+....+.##.+....+.#.
#..#..##....##..#..#.
####################.
