####################
#.....###@@###.....#
#.++..###@@###..+*.#
#..#.##@@@@@@#..+..#
#.....#@@@@@@#..+..#
####..###@@######+.#
#...+++.#@@#....#..#
#.+#...+..+..++.#+.#
#..#..##.+..##..#..#
#.+....+.##.+....+.#
#..#..##....##..#..#
####################
