####################.
#....#..#.#..#..#..#.
#.*#.#.##.+...+...##.
####.#....#..#.+...#.
#....#.##.#+.##.##.#.
#......+...+...+...#.
#@@###++##.+##+.##.#.
#@@#@#..#.+...+.#..#.
#@@@@#.++...##+.####.
#@@@@#..#####......#.
#@@@###........##..#.
####################.
