####################
#....#..#.#..#..#..#
#.*#.#.##.+...+...##
####.#....#..#.+...#
#....#.##.#+.##.##.#
#......+...+...+...#
#@@###++##.+##+.##.#
#@@#@#..#.+...+.#..#
#@@@@#.++...##+.####
#@@@@#..#####......#
#@@@###........##..#
####################
