####################
#@@@@#.......#..#..#
#@@@@#.#.+..+......#
#@@@@.##..+#.#.+#+.#
#@@@#...+...+#..+..#
#@@####..#.+...++..#
#......####.####.###
#........#...#.....#
#.##...#...+.#.+.+.#
#.##....+.##.+..+..#
#.....*#.....#...#.#
####################
