####################.
#@@@@#.......#..#..#.
#@@@@#.#.+..+......#.
#@@@@.##..+#.#.+#+.#.
#@@@#...+...+#..+..#.
#@@####..#.+...++..#.
#......####.####.###.
#........#...#.....#.
#.##...#...+.#.+.+.#.
#.##....+.##.+..+..#.
#.....*#.....#...#.#.
####################.
