####################
#@@@@###...........#
#@@@@#####.#..#+#.##
#@@@@###...#+..+...#
#@@@@###....+..#++##
##..####.+#..#+.+..#
##..####..+..+..#..#
#*..####+###+##.+..#
##........#..#..+..#
##...###..#..+..####
########..#..#.....#
####################
