####################.
#@@@@###...........#.
#@@@@#####.#..#+#.##.
#@@@@###...#+..+...#.
#@@@@###....+..#++##.
##..####.+#..#+.+..#.
##..####..+..+..#..#.
#*..####+###+##.+..#.
##........#..#..+..#.
##...###..#..+..####.
########..#..#.....#.
####################.
