####################.
#.....#.....*#@@@###.
#.....#......##@@@##.
#.#.#.##+##.##.@@@@#.
#...+.#...+++..@@@@#.
###+###.++..###.##@#.
#.....+..#....#.####.
#..+..#..###..#.#..#.
##.#+##....+..++...#.
#...+.##...#..#.#..#.
#.....#....#..#....#.
####################.
