####################
#.....#.....*#@@@###
#.....#......##@@@##
#.#.#.##+##.##.@@@@#
#...+.#...+++..@@@@#
###+###.++..###.##@#
#.....+..#....#.####
#..+..#..###..#.#..#
##.#+##....+..++...#
#...+.##...#..#.#..#
#.....#....#..#....#
####################
