####################.
#.....#..#@@@#*....#.
#.#.......@@@@#....#.
#..+..#...#@@@@#...#.
#.##+####.##@@@@#..#.
#.+...+..#..#@@@#..#.
#.++.#...#...#.++..#.
###..+++#...++..+..#.
#.+..#..#....#.+#..#.
#...+#..#.......+..#.
#..#....#....#..#..#.
####################.
