####################
#.....#..#@@@#*....#
#.#.......@@@@#....#
#..+..#...#@@@@#...#
#.##+####.##@@@@#..#
#.+...+..#..#@@@#..#
#.++.#...#...#.++..#
###..+++#...++..+..#
#.+..#..#....#.+#..#
#...+#..#.......+..#
#..#....#....#..#..#
####################
