####################
#####*###@##@@@##..#
#####+..@@#@@@#....#
####....@@@@@@#..+.#
###..+.#@@@@@##.#.##
##..++#.#####..+.+.#
##.+#.+....##..++..#
##..#..#....#.+..+.#
##...++.###.#+##...#
##.+#......+.+..+.##
###....#....#....###
####################
