####################.
#####*###@##@@@##..#.
#####+..@@#@@@#....#.
####....@@@@@@#..+.#.
###..+.#@@@@@##.#.##.
##..++#.#####..+.+.#.
##.+#.+....##..++..#.
##..#..#....#.+..+.#.
##...++.###.#+##...#.
##.+#......+.+..+.##.
###....#....#....###.
####################.
