####################.
#*.....#...#.......#.
##.###.##..####.#.##.
#....#.#..++.......#.
#..#.#.#.+.#.+.##.##.
#.....+.#..#++.#...#.
#..###..#......##.##.
#@@#@#.+.#..+.#....#.
#@@#@#..+.#.##.++..#.
#@@@@##...++..+..#.#.
#@@@@@##........#..#.
####################.
