####################
#*.....#...#.......#
##.###.##..####.#.##
#....#.#..++.......#
#..#.#.#.+.#.+.##.##
#.....+.#..#++.#...#
#..###..#......##.##
#@@#@#.+.#..+.#....#
#@@#@#..+.#.##.++..#
#@@@@##...++..+..#.#
#@@@@@##........#..#
####################
