####################.
#..#......#...#...##.
#.+#.+.+.##@@@+..+.#.
#..+..#.##@@@@#.+..#.
#.##.+.##@@@@#...+.#.
#.+....#@@@@##.+...#.
#.+##..#@@@#.......#.
#...+++##+##..###.##.
#.#.#..#...#..#....#.
#.+.#..+..##.......#.
#....#....#*.......#.
####################.
