####################
#..#......#...#...##
#.+#.+.+.##@@@+..+.#
#..+..#.##@@@@#.+..#
#.##.+.##@@@@#...+.#
#.+....#@@@@##.+...#
#.+##..#@@@#.......#
#...+++##+##..###.##
#.#.#..#...#..#....#
#.+.#..+..##.......#
#....#....#*.......#
####################
