.......#####..
.#######...##.
##.#.*##.++.#.
#....+......#.
#..+..###...#.
###.#####+###.
#.+..###.@@#..
#.+.+.+.@@@#..
#....###@@@#..
#.++.#.#@@@#..
#..###.#####..
####..........
