####################
#..#..#.#....#..#..#
#...+......+.+.....#
##.#..#+###+##..##.#
#...+.....+..#..+..#
#.###+##+#...#.+...#
#.#...+.+..######.+#
#.+..++.+..#*#@#@@@#
#.#.....#..#.#@#@@@#
#.##########.#@@@@@#
#............#@@@@@#
####################
