####################.
#..#..#.#....#..#..#.
#...+......+.+.....#.
##.#..#+###+##..##.#.
#...+.....+..#..+..#.
#.###+##+#...#.+...#.
#.#...+.+..######.+#.
#.+..++.+..#*#@#@@@#.
#.#.....#..#.#@#@@@#.
#.##########.#@@@@@#.
#............#@@@@@#.
####################.
