####################
#..#.....#..##....##
#.+#...+.#.....##..#
#.+..+..#@@#.....+.#
#.+.+..#@@@@#...#.##
#.+#..#@@@@@@###.+.#
#...#..#@@@@#..#+..#
#.+..####@@#...#...#
##.+...##.#.#.+..+##
###.+....+#*+.+#...#
####...#.......#...#
####################
