####################.
#..#.....#..##....##.
#.+#...+.#.....##..#.
#.+..+..#@@#.....+.#.
#.+.+..#@@@@#...#.##.
#.+#..#@@@@@@###.+.#.
#...#..#@@@@#..#+..#.
#.+..####@@#...#...#.
##.+...##.#.#.+..+##.
###.+....+#*+.+#...#.
####...#.......#...#.
####################.
