####################.
#......@@@@#....####.
#......@@@@........#.
#.#.##########.....#.
#.#+...#......###@@#.
#..+...#++###...#@@#.
#.+.###.+...+...#@@#.
#.+.#...+.+.#..##@@#.
#..#..++.#.+.##...##.
#*##.+#..+..+.....##.
##.......##...#..###.
####################.
