####################
#......@@@@#....####
#......@@@@........#
#.#.##########.....#
#.#+...#......###@@#
#..+...#++###...#@@#
#.+.###.+...+...#@@#
#.+.#...+.+.#..##@@#
#..#..++.#.+.##...##
#*##.+#..+..+.....##
##.......##...#..###
####################
