####################.
#........#...#*.#..#.
#.++..#++#.#.#..##.#.
#..#.+.+.#++.#.....#.
##.#..#..#.#.#..#..#.
#...##.......#.....#.
#...#.+.#...#...#..#.
#.+.#+.#...#..+.#@@#.
##+.#..####....#@@@#.
#..+..........#@@@@#.
#...#..#.....#@@@@@#.
####################.
