####################
#........#...#*.#..#
#.++..#++#.#.#..##.#
#..#.+.+.#++.#.....#
##.#..#..#.#.#..#..#
#...##.......#.....#
#...#.+.#...#...#..#
#.+.#+.#...#..+.#@@#
##+.#..####....#@@@#
#..+..........#@@@@#
#...#..#.....#@@@@@#
####################
