####################.
#.....#...#####....#.
##.+..#...####..+..#.
####.++...#@@#..#..#.
#..+..+..##@@####.##.
#.+...###@@@@...++.#.
#..#+#...@@@@#.#.+.#.
#.#..#.+.@@###+#...#.
#.#...+.#@@#...##..#.
#...+#..####...#.+##.
#.#..#....*#......##.
####################.
