####################
#.....#...#####....#
##.+..#...####..+..#
####.++...#@@#..#..#
#..+..+..##@@####.##
#.+...###@@@@...++.#
#..#+#...@@@@#.#.+.#
#.#..#.+.@@###+#...#
#.#...+.#@@#...##..#
#...+#..####...#.+##
#.#..#....*#......##
####################
