####################.
#...#...#....#...#*#.
#...+..+.....#.+.#.#.
##+#.+###.#....++#.#.
#..#..#@###..#+.+..#.
#..#+#@@@@#..#.###.#.
#.+..#@@@@@##....#.#.
##+..#@#@@@@#++.+..#.
#..######@@##.#..#.#.
#..+.........+.###.#.
#...#...#........#.#.
####################.
