####################
#...#...#....#...#*#
#...+..+.....#.+.#.#
##+#.+###.#....++#.#
#..#..#@###..#+.+..#
#..#+#@@@@#..#.###.#
#.+..#@@@@@##....#.#
##+..#@#@@@@#++.+..#
#..######@@##.#..#.#
#..+.........+.###.#
#...#...#........#.#
####################
