####################.
#.#.#.#...#*##...#.#.
#.............+....#.
#..##+#.#####.+.#.##.
##....##@@@@@#..#..#.
##+##+#@@@@@###+#+.#.
#...#.##@@@@@#..#.##.
#..+....##@@##..#..#.
#.+.#...+...+..+++.#.
##.+..+#.#..#..+...#.
#...##...#..#......#.
####################.
