####################
#.#.#.#...#*##...#.#
#.............+....#
#..##+#.#####.+.#.##
##....##@@@@@#..#..#
##+##+#@@@@@###+#+.#
#...#.##@@@@@#..#.##
#..+....##@@##..#..#
#.+.#...+...+..+++.#
##.+..+#.#..#..+...#
#...##...#..#......#
####################
