####################.
#....##...#....#...#.
#..+..+.....##.+...#.
##.#####..@######.##.
.#.##..##@@@@####.##.
##.##+.###@@##.....#.
#......#@@@.@#.+.+.#.
#.+.##.##.@.###.####.
#.#.+....#@##.#.#....
#.+.+.#...@####.##...
#.#..##.#.##..#..##..
#######..+##+...+.#..
......##......+.#*#..
.......#..##.######..
.......#######.......
