####################
#....##...#....#...#
#..+..+.....##.+...#
##.#####..@######.##
.#.##..##@@@@####.##
##.##+.###@@##.....#
#......#@@@.@#.+.+.#
#.+.##.##.@.###.####
#.#.+....#@##.#.#...
#.+.+.#...@####.##..
#.#..##.#.##..#..##.
#######..+##+...+.#.
......##......+.#*#.
.......#..##.######.
.......#######......
