.......###########..
.......#.........#..
.......#....+.+..#..
######.#.+.#####.#..
#....#####.+..##+#..
#.......+.+......#..
#..........##.##.#..
#....##*#####.##.#..
#....####...#.##.##.
#@@@@#......#.+...#.
#@@@@#......#.....#.
######......#######.
