.......###########.
.......#.........#.
.......#....+.+..#.
######.#.+.#####.#.
#....#####.+..##+#.
#.......+.+......#.
#..........##.##.#.
#....##*#####.##.#.
#....####...#.##.##
#@@@@#......#.+...#
#@@@@#......#.....#
######......#######
