#############
#...........#
#.###.++....#
#...#.+..+..#
#..+####+####
#.+.##.......
#..++.+......
###.##.++#...
..#.##...#...
..#......#...
..###*#######
....###......
