#############.......
#...........#.......
#.###.++....#.......
#...#.+..+..#.......
#..+####+######.....
#.+.##........#####.
#..++.+........@@@#.
###.##.++#.....@@@#.
..#.##...#.....@@@#.
..#......#.....@@@#.
..###*#############.
....###.............
