..####...........
..#..###########.
..#....+...+.+.#.
..#.+#.+.#..+..#.
..#..+.+..#....#.
###.+#.#..####.#.
#*#+.+.+..##...#.
#....+.#+#...#.#.
#...+....+.+.+.#.
#####..#########.
..#......#.......
..#......#.......
..#@@@@@@#.......
..#@@@@@@#.......
..#@@@@@@#.......
..########.......
