..####..........
..#..###########
..#....+...+.+.#
..#.+#.+.#..+..#
..#..+.+..#....#
###.+#.#..####.#
#*#+.+.+..##...#
#....+.#+#...#.#
#...+....+.+.+.#
#####..#########
..#......#......
..#......#......
..#@@@@@@#......
..#@@@@@@#......
..#@@@@@@#......
..########......
