..#################
###*##.........@@@#
#....#.........@@@#
#.+..#.........@@@#
#.++.#.........@@@#
##.+.###+##########
.#.###..+.#........
##...+..+.#........
#..+.#..+.#........
#.+..#....#........
#..+.#....#........
#....#....#........
###########........
