..#################.
###*##.........@@@#.
#....#.........@@@#.
#.+..#.........@@@#.
#.++.#.........@@@#.
##.+.###+##########.
.#.###..+.#.........
##...+..+.#.........
#..+.#..+.#.........
#.+..#....#.........
#..+.#....#.........
#....#....#.........
###########.........
