..............#####.
.....##########...#.
.....#........#...#.
.....#..+.+....++.#.
.....#.#####.##.+.#.
.....#++...#+##.+.#.
.....#.###.#.##+..#.
######.###.+.+....#.
#@@@@........##...#.
#@@@@........######.
#@@@@........#......
###########*##......
..........###.......
