..............#####
.....##########...#
.....#........#...#
.....#..+.+....++.#
.....#.#####.##.+.#
.....#++...#+##.+.#
.....#.###.#.##+..#
######.###.+.+....#
#@@@@........##...#
#@@@@........######
#@@@@........#.....
###########*##.....
..........###......
