....######.......
.####....#.......
.#....##.#.......
.#.+.....#.......
###.####.########
#..+...+.##..@@@#
#...++.++....@@@#
#....+..+##..@@@#
##*##.##.##..@@@#
.###..+..########
.#...++..#.......
.#....#..#.......
.#########.......
