....######........
.####....#........
.#....##.#........
.#.+.....#........
###.####.########.
#..+...+.##..@@@#.
#...++.++....@@@#.
#....+..+##..@@@#.
##*##.##.##..@@@#.
.###..+..########.
.#...++..#........
.#....#..#........
.#########........
