#######.#########.
#.....#.#...##..#.
#.###.#.#...+...#.
#.#.+.###...+...#.
#...++......##+.#.
#....####...##..#.
#*############.##.
###@@....#####+.#.
..#@@....####...#.
..#@@.......++..#.
..#@@....####.+.#.
..#@@....#..#...#.
..########..#####.
