#######.#########
#.....#.#...##..#
#.###.#.#...+...#
#.#.+.###...+...#
#...++......##+.#
#....####...##..#
#*############.##
###@@....#####+.#
..#@@....####...#
..#@@.......++..#
..#@@....####.+.#
..#@@....#..#...#
..########..#####
