#######.........
#.....##########
#.....#....#..##
#.+...#...+.+..#
#..+..#..+.##..#
#.++..##+.+....#
##.#..##.#######
##.#..##....@@@#
#..#+.......@@@#
#...++......@@@#
#.....##*#..@@@#
################
