#######..........
#.....##########.
#.....#....#..##.
#.+...#...+.+..#.
#..+..#..+.##..#.
#.++..##+.+....#.
##.#..##.#######.
##.#..##....@@@#.
#..#+.......@@@#.
#...++......@@@#.
#.....##*#..@@@#.
################.
