############.........
#......#...##........
#.+..+...#..######...
####..#####......#...
.#@@..#.....####.#...
.#@####..####....#...
.#@@@@....#..+.####..
.#.@@@#...#.+++#..##.
###@####.##..+*+...#.
#.....#####.+.#....#.
#.#@#.+......+###+.#.
#.#@########..#..+.#.
#.#@@........##..+.#.
#.#.#######.+.#.#..#.
#...#.....#.......##.
#####.....##########.
