############........
#......#...##.......
#.+..+...#..######..
####..#####......#..
.#@@..#.....####.#..
.#@####..####....#..
.#@@@@....#..+.####.
.#.@@@#...#.+++#..##
###@####.##..+*+...#
#.....#####.+.#....#
#.#@#.+......+###+.#
#.#@########..#..+.#
#.#@@........##..+.#
#.#.#######.+.#.#..#
#...#.....#.......##
#####.....##########
