################
#.......#*.#...#
#.#.#.#.#.+..++#
#.#@@@#.#+++...#
#..@@@#.#.+..++#
#.##@##.#.##....
#.#@@@.....+....
#.##.###..######
#....#.####.....
######..........
