################..
#.......#*.#...#..
#.#.#.#.#.+..++#..
#.#@@@#.#+++...#..
#..@@@#.#.+..++##.
#.##@##.#.##....#.
#.#@@@.....+....#.
#.##.###..#######.
#....#.####.......
######............
