....#####.......
.####...##.#####
.#..+....###...#
.#.+*+.+....+..#
.#.#+########.##
.#.#..+..#.....#
.#.#.+.+.#.#...#
##.#..+#.#.#####
#..##....#.....#
#....+.#.###...#
#####.##..#@@@@#
#....+.....@@@@#
#.........#@@@@#
################
