....#####........
.####...##.#####.
.#..+....###...#.
.#.+*+.+....+..#.
.#.#+########.##.
.#.#..+..#.....#.
.#.#.+.+.#.#...#.
##.#..+#.#.#####.
#..##....#.....#.
#....+.#.###...#.
#####.##..#@@@@#.
#....+.....@@@@#.
#.........#@@@@#.
################.
