#############
#@@@@@@@@####
#@@@####.#..#
#@@@#..###...
#@@@++.....+.
#..@#..+.+#.+
#@@@#.#+#...+
#@#.#.+...+..
#@..#+###+###
##..#...+.+..
.#..#..+*+..#
.#..#.####.+.
.#..#....###.
.#..#.++.#.##
.#..#....#...
.#########...
