#############.....
#@@@@@@@@####.....
#@@@####.#..#####.
#@@@#..###....+.#.
#@@@++.....+.+..#.
#..@#..+.+#.+..##.
#@@@#.#+#...+..#..
#@#.#.+...+....#..
#@..#+###+####+#..
##..#...+.+....#..
.#..#..+*+..#..#..
.#..#.####.+..+#..
.#..#....###...#..
.#..#.++.#.#####..
.#..#....#........
.#########........
