.##################..
.#...+.......@@@#@##.
.#.......####@@@@@.#.
.#.#######..#@@@@@.#.
.#.#....+.+.##@@@@##.
.#.#..+.#.#.###@@@#..
.#.#.+*+.+..#####.#..
##.#..+..+.++...+.#..
#..#+#.+#...#.+##.#..
#.##....##.##.+.#.#..
#.#.+#.+.+..#.....#..
#.#.........#######..
#.########+##...#....
#........#..+...#....
########....#####....
.......###..#........
.........####........
