.################
.#...+.......@@@#
.#.......####@@@@
.#.#######..#@@@@
.#.#....+.+.##@@@
.#.#..+.#.#.###@@
.#.#.+*+.+..#####
##.#..+..+.++...+
#..#+#.+#...#.+##
#.##....##.##.+.#
#.#.+#.+.+..#....
#.#.........#####
#.########+##...#
#........#..+...#
########....#####
.......###..#....
.........####....
