..........#######
..........#..@@@#
......#####..@@@#
......#......@.@#
......#..##..@@@#
......##.##..@@@#
.....###.########
.....#.+++.##....
.#####..+.+.#####
##...#+.+...#...#
#*.+..+....+..+.#
######.++.+.#####
.....#......#....
.....########....
