..........#######.
..........#..@@@#.
......#####..@@@#.
......#......@.@#.
......#..##..@@@#.
......##.##..@@@#.
.....###.########.
.....#.+++.##.....
.#####..+.+.#####.
##...#+.+...#...#.
#*.+..+....+..+.#.
######.++.+.#####.
.....#......#.....
.....########.....
