####################.
#@@#....#..........#.
#@+..+..#++..+##.+##.
#@+#..###..##.##...#.
#..#.+.#..++...+...#.
#.###..#.#..#+..####.
#..##.#.+...#*.#...#.
#.+....+..##@##..+.#.
#..#.+#.+#.+.....###.
#..#..#..#...###...#.
#..########.#......#.
#...........#..#@#@#.
##+########+#...@@@#.
#....@!..#....##@#@#.
#.@!@@@!...+..@@@@@#.
####################.
.....................
