####################
#@@#....#..........#
#@+..+..#++..+##.+##
#@+#..###..##.##...#
#..#.+.#..++...+...#
#.###..#.#..#+..####
#..##.#.+...#*.#...#
#.+....+..##@##..+.#
#..#.+#.+#.+.....###
#..#..#..#...###...#
#..########.#......#
#...........#..#@#@#
##+########+#...@@@#
#....@!..#....##@#@#
#.@!@@@!...+..@@@@@#
####################
....................
